,,,,,,,,,,,,,,,,,,,,,,,,,,,,,,,,,,,,,,,,,,,,,,,,,,,,,,,,,,,,,,,,,,,,,,,,,,,,,,,,,,,,,,,,,,,,,,,,,,,,,,,,,,,,,,,,,,,,,,,,,,,,,,,,,,,,,,,,,,,,
,,,,,,,,,,,,,,,,,,,,,,,,,,,,,,,,,,,,,,,,,,,,,,,,,,,,,,,,,,,,,,,,,,,,,,,,,,,,,,,,,,,,,,,,,,,,,,,,,,,,,,,,,,,,,,,,,,,,,,,,, Month: ,Jul-25,,,,,,,,,,,,,,,,,,
,,,,,,,,,,,,,,,,,,,,,,,,,,,,,,,,,,,,,,,,,,,,,,,,,,,,,,,,,,,,,,,,,,,,,,,,,,,,,,,,,,,,,,,,,,,,,,,,,,,,,,,,,,,,,,,,,,,,,,,,,,,,,,,,,,,,,,,,,,,,
Monthly Transient Business Tracking,,,,,,,,,,,,,,,,,,,,,,,,,,= Rate Change,,,,,,,,,,,,,,,,,,,,,,,,,,,,,,,,,,,,,,,,,,,,,,,,,,,,,,,,,,,,,,,,,,,,,,,,,,,,,,,,,,,,,,,,,,,,,,, Days in Month: ,31,,,,,,,,,,,,,,,,,,
,,,,,,,,,,,,,,,,,,,,,,,,,,,,,,,,,,,,,,,,,,,,,,,,,,,,,,,,,,,,,,,,,,,,,,,,,,,,,,,,,,,,,,,,,,,,,,,,,,,,,,,,,,,,,,,,,,,,,,,,,,,,,,,,,,,,,,,,,,,,
No. of Total Parking Spaces:,,,,,,,,,,,,,,,,,,,,,,,,,,,,,,,,,,,,,,,,,,,,,,,,,,,,,,,,,,,,,,,,,,,,,,,,,,,,,,,,,,,,,,,,,,,,,,,,,,,,,,,,,,,,,,,,,,,,,,,,," Gross Transient, Flex Daily &  Online Budget "," $2,985,141.00 ",,,,,,,,,,,,,,,,,,
,,,,,,,,,,,,,,,,,,,,,,,,,,,,,,,,,,,,,,,,,,,,,,,,,,,,,,,,,,,,,,,,,,,,,,,,,,,,,,,,,,,,,,,,,,,,,,,,,,,,,,,,,,,,,,,,,,,,,,,,, Reforecasted Budget ,,,,,,,,,,,,,,,,,,,
,," 9,176 ",,,,,,,,,,,,,,,,,,,,,,,,,,,,,,,,,,,,,,,,,,,,,,,,,,,,,,,,,,,,,,,,,,,,,,,,,,,,,,,,,,,,,,,,,,,,,,,,,,,,,,,,,,,,,,,,,,,,,,, Gross Budget Critical Number: , $10.49 ,,,,,,,,,,,,,,,,,,
,,,,,,,,,,,,,,,,,,,,,,,,,,,,,,,,,,,,,,,,,,,,,,,,,,,,,,,,,,,,,,,,,,,,,,,,,,,,,,,,,,,,,,,,,,,,,,,,,,,,,,,,,,,,,,,,,,,,,,,,,,,,,,,,,,,,,,,,,,,,
,Date and D.O.W.,,Grant Park North,,,,,,Grant Park South,,,,,,Lakeside,,,,,,Millennium Park,,,,,,Online Sales,, Transient/Daily  Statistics ,,,,,,,,,, # , Logical testing checking for inclusion of data ,,,,,,, Weekday Unit Tracking - GPN ,,,,,,, Weekday Unit Tracking - GPS ,,,,,,, Weekday Unit Tracking - EMG ,,,,,,, Weekday Unit Tracking - MPG ,,,,,,, Weekday Unit Tracking - Online ,,,,,,, Weekday Revenue Tracking - GPN ,,,,,,, Weekday Revenue Tracking - GPS ,,,,,,, Weekday Revenue Tracking - EMG ,,,,,,, Weekday Revenue Tracking - MPG ,,,,,,, Weekday Revenue Tracking - Online ,,,,,,, Flex Daily , Transient , Online , Combined , Balance v. Budget , Balance v. Reforecast , CN , CN , Avg $ , Notes ,,,,,,,,,,,,,,
,,,Flex Daily Units,Flex Daily Revenue,Transient Units,Transient Revenue ,Total Units,Total Flex Daily    & Transient Revenue ,Flex Daily Units,Flex Daily Revenue,Transient Units,Transient Revenue ,Total Units,Total Flex Daily    & Transient Revenue ,Flex Daily Units,Flex Daily Revenue,Transient Units,Transient Revenue ,Total Units,Total Flex Daily    & Transient Revenue ,Flex Daily Units,Flex Daily Revenue,Transient Units,Transient Revenue ,Total Units,Total Flex Daily    & Transient Revenue ,Daily Units,Revenue,Total Flex Daily Units, Transient Units , Online  , Total Units , Flex Daily Revenue , Transient Revenue , Online  Revenue , Total Revenue , Debit Units , Revenue , Days , MON , TUE , WED , THU , FRI , SAT , SUN , MON , TUE , WED , THU , FRI , SAT , SUN , MON , TUE , WED , THU , FRI , SAT , SUN , MON , TUE , WED , THU , FRI , SAT , SUN , MON , TUE , WED , THU , FRI , SAT , SUN , MON , TUE , WED , THU , FRI , SAT , SUN , MON , TUE , WED , THU , FRI , SAT , SUN , MON , TUE , WED , THU , FRI , SAT , SUN , MON , TUE , WED , THU , FRI , SAT , SUN , MON , TUE , WED , THU , FRI , SAT , SUN , MON , TUE , WED , THU , FRI , SAT , SUN , Avg. Ticket , Avg. Ticket , Avg. Ticket , Avg. Ticket ,,, Daily , MTD , of Gas ,,,,,,,,,,,,,,,
,1,TUE, 205 ," $3,146.00 ", 618 ," $22,198.00 ", 823 ," $25,344.00 ", 135 ," $1,974.35 ", 144 ," $4,745.00 ", 279 ," $6,719.35 ", 357 ," $5,437.05 ", 114 ," $3,260.70 ", 471 ," $8,697.75 ", 89 ," $1,292.86 ", 321 ," $12,284.56 ", 410 ," $13,577.42 "," 1,162 "," $14,927.84 ", 786 ," 1,197 "," 1,162 "," 3,145 "," $11,850.26 "," $42,488.26 "," $14,927.84 "," $69,266.36 ", -   , $-   , 1 , FALSE , TRUE , FALSE , FALSE , FALSE , FALSE , FALSE , FALSE , 205 , FALSE , FALSE , FALSE , FALSE , FALSE , FALSE , 279 , FALSE , FALSE , FALSE , FALSE , FALSE , FALSE , 471 , FALSE , FALSE , FALSE , FALSE , FALSE , FALSE , 410 , FALSE , FALSE , FALSE , FALSE , FALSE , FALSE ," 1,162 ", FALSE , FALSE , FALSE , FALSE , FALSE , FALSE ," $22,198.00 ", FALSE , FALSE , FALSE , FALSE , FALSE , FALSE ," $6,719.35 ", FALSE , FALSE , FALSE , FALSE , FALSE , FALSE ," $8,697.75 ", FALSE , FALSE , FALSE , FALSE , FALSE , FALSE ," $13,577.42 ", FALSE , FALSE , FALSE , FALSE , FALSE , FALSE ," $14,927.84 ", FALSE , FALSE , FALSE , FALSE , FALSE , $15.08 , $35.50 , $12.85 , $22.02 ," $(2,915,874.64)"," $69,266.36 ", $7.55 , $7.55 , $3.50 ,MP Summer Film Series - Opening Night - The Sandlot. High temperature 87 degrees fahrenheit.,,,,,,,,,,,,,,
,2,WED, 171 ," $2,626.80 ", 605 ," $21,943.50 ", 776 ," $24,570.30 ", 114 ," $1,672.98 ", 166 ," $5,217.00 ", 280 ," $6,889.98 ", 281 ," $4,287.09 ", 123 ," $3,505.51 ", 404 ," $7,792.60 ", 155 ," $2,242.76 ", 401 ," $15,574.46 ", 556 ," $17,817.22 "," 1,421 "," $19,731.78 ", 721 ," 1,295 "," 1,421 "," 3,437 "," $10,829.63 "," $46,240.47 "," $19,731.78 "," $76,801.88 ", -   , $-   , 1 , FALSE , FALSE , TRUE , FALSE , FALSE , FALSE , FALSE , FALSE , FALSE , 171 , FALSE , FALSE , FALSE , FALSE , FALSE , FALSE , 280 , FALSE , FALSE , FALSE , FALSE , FALSE , FALSE , 404 , FALSE , FALSE , FALSE , FALSE , FALSE , FALSE , 556 , FALSE , FALSE , FALSE , FALSE , FALSE , FALSE ," 1,421 ", FALSE , FALSE , FALSE , FALSE , FALSE , FALSE ," $21,943.50 ", FALSE , FALSE , FALSE , FALSE , FALSE , FALSE ," $6,889.98 ", FALSE , FALSE , FALSE , FALSE , FALSE , FALSE ," $7,792.60 ", FALSE , FALSE , FALSE , FALSE , FALSE , FALSE ," $17,817.22 ", FALSE , FALSE , FALSE , FALSE , FALSE , FALSE ," $19,731.78 ", FALSE , FALSE , FALSE , FALSE , $15.02 , $35.71 , $13.89 , $22.35 ," $(2,839,072.76)"," $146,068.24 ", $8.37 , $7.96 , $3.50 ,GPMF. High temperature 91 degrees fahrenheit. GPS full closure at midnight for NASCAR.,,,,,,,,,,,,,,
,3,THU, 115 ," $1,837.52 ", 669 ," $25,398.50 ", 784 ," $27,236.02 ", 39 , $548.00 , 158 ," $5,617.00 ", 197 ," $6,165.00 ", 117 ," $1,775.70 ", 48 ," $1,460.00 ", 165 ," $3,235.70 ", 85 ," $1,223.54 ", 206 ," $7,737.62 ", 291 ," $8,961.16 "," 1,112 "," $16,246.47 ", 356 ," 1,081 "," 1,112 "," 2,549 "," $5,384.76 "," $40,213.12 "," $16,246.47 "," $61,844.35 ", -   , $-   , 1 , FALSE , FALSE , FALSE , TRUE , FALSE , FALSE , FALSE , FALSE , FALSE , FALSE , 115 , FALSE , FALSE , FALSE , FALSE , FALSE , FALSE , 197 , FALSE , FALSE , FALSE , FALSE , FALSE , FALSE , 165 , FALSE , FALSE , FALSE , FALSE , FALSE , FALSE , 291 , FALSE , FALSE , FALSE , FALSE , FALSE , FALSE ," 1,112 ", FALSE , FALSE , FALSE , FALSE , FALSE , FALSE ," $25,398.50 ", FALSE , FALSE , FALSE , FALSE , FALSE , FALSE ," $6,165.00 ", FALSE , FALSE , FALSE , FALSE , FALSE , FALSE ," $3,235.70 ", FALSE , FALSE , FALSE , FALSE , FALSE , FALSE ," $8,961.16 ", FALSE , FALSE , FALSE , FALSE , FALSE , FALSE ," $16,246.47 ", FALSE , FALSE , FALSE , $15.13 , $37.20 , $14.61 , $24.26 ," $(2,777,228.41)"," $207,912.59 ", $6.74 , $7.55 , $3.50 ,GPMF. High temperature 95 degrees fahrenheit.,,,,,,,,,,,,,,
,4,FRI, 19 , $283.30 , 957 ," $39,444.00 ", 976 ," $39,727.30 ", - , $-   , 8 , $376.00 , 8 , $376.00 , 8 , $112.66 , 36 ," $1,489.00 ", 44 ," $1,601.66 ", 68 ," $1,041.72 ", 202 ," $8,343.00 ", 270 ," $9,384.72 "," 1,086 "," $15,736.28 ", 95 ," 1,203 "," 1,086 "," 2,384 "," $1,437.68 "," $49,652.00 "," $15,736.28 "," $66,825.96 ", -   , $-   , 1 , FALSE , FALSE , FALSE , FALSE , TRUE , FALSE , FALSE , FALSE , FALSE , FALSE , FALSE , 19 , FALSE , FALSE , FALSE , FALSE , FALSE , FALSE , 8 , FALSE , FALSE , FALSE , FALSE , FALSE , FALSE , 44 , FALSE , FALSE , FALSE , FALSE , FALSE , FALSE , 270 , FALSE , FALSE , FALSE , FALSE , FALSE , FALSE ," 1,086 ", FALSE , FALSE , FALSE , FALSE , FALSE , FALSE ," $39,444.00 ", FALSE , FALSE , FALSE , FALSE , FALSE , FALSE , $376.00 , FALSE , FALSE , FALSE , FALSE , FALSE , FALSE ," $1,601.66 ", FALSE , FALSE , FALSE , FALSE , FALSE , FALSE ," $9,384.72 ", FALSE , FALSE , FALSE , FALSE , FALSE , FALSE ," $15,736.28 ", FALSE , FALSE , $15.13 , $41.27 , $14.49 , $28.03 ," $(2,710,402.45)"," $274,738.55 ", $7.28 , $7.49 , $3.50 ,"4th of July. Independence Day Salute - Pritzker. High temperature 92 degrees fahrenheit with 0.05"" rain.",,,,,,,,,,,,,,
,5,SAT, 23 , $371.50 ," 1,252 "," $56,204.00 "," 1,275 "," $56,575.50 ", - , $-   , - , $-   , - , $-   , 16 , $239.90 , 87 ," $3,771.50 ", 103 ," $4,011.40 ", 21 , $300.02 , 324 ," $14,787.50 ", 345 ," $15,087.52 "," 1,295 "," $29,983.89 ", 60 ," 1,663 "," 1,295 "," 3,018 ", $911.42 ," $74,763.00 "," $29,983.89 "," $105,658.31 ", -   , $-   , 1 , FALSE , FALSE , FALSE , FALSE , FALSE , TRUE , FALSE , FALSE , FALSE , FALSE , FALSE , FALSE , 23 , FALSE , FALSE , FALSE , FALSE , FALSE , FALSE , -   , FALSE , FALSE , FALSE , FALSE , FALSE , FALSE , 103 , FALSE , FALSE , FALSE , FALSE , FALSE , FALSE , 345 , FALSE , FALSE , FALSE , FALSE , FALSE , FALSE ," 1,295 ", FALSE , FALSE , FALSE , FALSE , FALSE , FALSE ," $56,204.00 ", FALSE , FALSE , FALSE , FALSE , FALSE , FALSE , $-   , FALSE , FALSE , FALSE , FALSE , FALSE , FALSE ," $4,011.40 ", FALSE , FALSE , FALSE , FALSE , FALSE , FALSE ," $15,087.52 ", FALSE , FALSE , FALSE , FALSE , FALSE , FALSE ," $29,983.89 ", FALSE , $15.19 , $44.96 , $23.15 , $35.01 ," $(2,604,744.14)"," $380,396.86 ", $11.51 , $8.29 , $3.50 ,NASCAR Race. Fireworks at Navy Pier. High temperature 94 degrees fahrenheit. ,,,,,,,,,,,,,,
,6,SUN, 16 , $251.26 ," 1,004 "," $44,708.00 "," 1,020 "," $44,959.26 ", 1 , $13.50 , - , $-   , 1 , $13.50 , 12 , $164.92 , 34 ," $1,637.00 ", 46 ," $1,801.92 ", 20 , $334.62 , 339 ," $15,756.00 ", 359 ," $16,090.62 "," 1,291 "," $41,060.60 ", 49 ," 1,377 "," 1,291 "," 2,717 ", $764.30 ," $62,101.00 "," $41,060.60 "," $103,925.90 ", -   , $-   , 1 , FALSE , FALSE , FALSE , FALSE , FALSE , FALSE , TRUE , FALSE , FALSE , FALSE , FALSE , FALSE , FALSE , 16 , FALSE , FALSE , FALSE , FALSE , FALSE , FALSE , 1 , FALSE , FALSE , FALSE , FALSE , FALSE , FALSE , 46 , FALSE , FALSE , FALSE , FALSE , FALSE , FALSE , 359 , FALSE , FALSE , FALSE , FALSE , FALSE , FALSE ," 1,291 ", FALSE , FALSE , FALSE , FALSE , FALSE , FALSE ," $44,708.00 ", FALSE , FALSE , FALSE , FALSE , FALSE , FALSE , $13.50 , FALSE , FALSE , FALSE , FALSE , FALSE , FALSE ," $1,801.92 ", FALSE , FALSE , FALSE , FALSE , FALSE , FALSE ," $16,090.62 ", FALSE , FALSE , FALSE , FALSE , FALSE , FALSE ," $41,060.60 ", $15.60 , $45.10 , $31.81 , $38.25 ," $(2,500,818.24)"," $484,322.76 ", $11.33 , $8.80 , $3.50 ,"NASCAR Race. High temperature 85 degrees fahrenheit with 0.61"" rain - rain was after the race completed.",,,,,,,,,,,,,,
,7,MON, 171 ," $2,620.56 ", 789 ," $29,160.00 ", 960 ," $31,780.56 ", 61 , $895.67 , 172 ," $6,149.04 ", 233 ," $7,044.71 ", 208 ," $3,074.60 ", 67 ," $1,964.10 ", 275 ," $5,038.70 ", 73 ," $1,047.98 ", 229 ," $8,517.50 ", 302 ," $9,565.48 "," 1,549 "," $21,312.94 ", 513 ," 1,257 "," 1,549 "," 3,319 "," $7,638.81 "," $45,790.64 "," $21,312.94 "," $74,742.39 ", -   , $-   , 1 , TRUE , FALSE , FALSE , FALSE , FALSE , FALSE , FALSE , 171 , FALSE , FALSE , FALSE , FALSE , FALSE , FALSE , 233 , FALSE , FALSE , FALSE , FALSE , FALSE , FALSE , 275 , FALSE , FALSE , FALSE , FALSE , FALSE , FALSE , 302 , FALSE , FALSE , FALSE , FALSE , FALSE , FALSE ," 1,549 ", FALSE , FALSE , FALSE , FALSE , FALSE , FALSE ," $29,160.00 ", FALSE , FALSE , FALSE , FALSE , FALSE , FALSE ," $7,044.71 ", FALSE , FALSE , FALSE , FALSE , FALSE , FALSE ," $5,038.70 ", FALSE , FALSE , FALSE , FALSE , FALSE , FALSE ," $9,565.48 ", FALSE , FALSE , FALSE , FALSE , FALSE , FALSE ," $21,312.94 ", FALSE , FALSE , FALSE , FALSE , FALSE , FALSE , $14.89 , $36.43 , $13.76 , $22.52 ," $(2,426,075.85)"," $559,065.15 ", $8.15 , $8.70 , $3.50 ,MP Summer Music Series. High temperature 83 degrees fahrenheit.,,,,,,,,,,,,,,
,8,TUE, 224 ," $3,552.02 ", 543 ," $17,931.00 ", 767 ," $21,483.02 ", 194 ," $2,849.05 ", 127 ," $4,088.00 ", 321 ," $6,937.05 ", 344 ," $5,171.00 ", 93 ," $3,072.70 ", 437 ," $8,243.70 ", 103 ," $1,518.42 ", 255 ," $9,573.00 ", 358 ," $11,091.42 "," 1,256 "," $17,263.84 ", 865 ," 1,018 "," 1,256 "," 3,139 "," $13,090.49 "," $34,664.70 "," $17,263.84 "," $65,019.03 ", -   , $-   , 1 , FALSE , TRUE , FALSE , FALSE , FALSE , FALSE , FALSE , FALSE , 224 , FALSE , FALSE , FALSE , FALSE , FALSE , FALSE , 321 , FALSE , FALSE , FALSE , FALSE , FALSE , FALSE , 437 , FALSE , FALSE , FALSE , FALSE , FALSE , FALSE , 358 , FALSE , FALSE , FALSE , FALSE , FALSE , FALSE ," 1,256 ", FALSE , FALSE , FALSE , FALSE , FALSE , FALSE ," $17,931.00 ", FALSE , FALSE , FALSE , FALSE , FALSE , FALSE ," $6,937.05 ", FALSE , FALSE , FALSE , FALSE , FALSE , FALSE ," $8,243.70 ", FALSE , FALSE , FALSE , FALSE , FALSE , FALSE ," $11,091.42 ", FALSE , FALSE , FALSE , FALSE , FALSE , FALSE ," $17,263.84 ", FALSE , FALSE , FALSE , FALSE , FALSE , $15.13 , $34.05 , $13.75 , $20.71 ," $(2,361,056.82)"," $624,084.18 ", $7.09 , $8.50 , $3.58 ,"MP Summer Film Series - Harry Potter and the Goblet of Fire. High temperature 84 degrees fahrenheit with 0.07"" rain.",,,,,,,,,,,,,,
,9,WED, 218 ," $4,074.66 ", 690 ," $24,404.00 ", 908 ," $28,478.66 ", 226 ," $3,338.06 ", 178 ," $6,053.00 ", 404 ," $9,391.06 ", 408 ," $6,042.57 ", 143 ," $4,530.50 ", 551 ," $10,573.07 ", 216 ," $3,133.74 ", 362 ," $13,350.00 ", 578 ," $16,483.74 "," 1,551 "," $21,201.75 "," 1,068 "," 1,373 "," 1,551 "," 3,992 "," $16,589.03 "," $48,337.50 "," $21,201.75 "," $86,128.28 ", -   , $-   , 1 , FALSE , FALSE , TRUE , FALSE , FALSE , FALSE , FALSE , FALSE , FALSE , 218 , FALSE , FALSE , FALSE , FALSE , FALSE , FALSE , 404 , FALSE , FALSE , FALSE , FALSE , FALSE , FALSE , 551 , FALSE , FALSE , FALSE , FALSE , FALSE , FALSE , 578 , FALSE , FALSE , FALSE , FALSE , FALSE , FALSE ," 1,551 ", FALSE , FALSE , FALSE , FALSE , FALSE , FALSE ," $24,404.00 ", FALSE , FALSE , FALSE , FALSE , FALSE , FALSE ," $9,391.06 ", FALSE , FALSE , FALSE , FALSE , FALSE , FALSE ," $10,573.07 ", FALSE , FALSE , FALSE , FALSE , FALSE , FALSE ," $16,483.74 ", FALSE , FALSE , FALSE , FALSE , FALSE , FALSE ," $21,201.75 ", FALSE , FALSE , FALSE , FALSE , $15.53 , $35.21 , $13.67 , $21.58 ," $(2,274,928.54)"," $710,212.46 ", $9.39 , $8.60 , $3.58 ,"GPMF. High temperature 85 degrees fahrenheit with 0.01"" rain.",,,,,,,,,,,,,,
,10,THU, 205 ," $3,183.52 ", 674 ," $23,449.00 ", 879 ," $26,632.52 ", 180 ," $2,664.23 ", 217 ," $7,500.00 ", 397 ," $10,164.23 ", 293 ," $4,437.50 ", 129 ," $3,495.70 ", 422 ," $7,933.20 ", 143 ," $2,106.66 ", 389 ," $14,219.50 ", 532 ," $16,326.16 "," 1,610 "," $21,860.89 ", 821 ," 1,409 "," 1,610 "," 3,840 "," $12,391.91 "," $48,664.20 "," $21,860.89 "," $82,917.00 ", -   , $-   , 1 , FALSE , FALSE , FALSE , TRUE , FALSE , FALSE , FALSE , FALSE , FALSE , FALSE , 205 , FALSE , FALSE , FALSE , FALSE , FALSE , FALSE , 397 , FALSE , FALSE , FALSE , FALSE , FALSE , FALSE , 422 , FALSE , FALSE , FALSE , FALSE , FALSE , FALSE , 532 , FALSE , FALSE , FALSE , FALSE , FALSE , FALSE ," 1,610 ", FALSE , FALSE , FALSE , FALSE , FALSE , FALSE ," $23,449.00 ", FALSE , FALSE , FALSE , FALSE , FALSE , FALSE ," $10,164.23 ", FALSE , FALSE , FALSE , FALSE , FALSE , FALSE ," $7,933.20 ", FALSE , FALSE , FALSE , FALSE , FALSE , FALSE ," $16,326.16 ", FALSE , FALSE , FALSE , FALSE , FALSE , FALSE ," $21,860.89 ", FALSE , FALSE , FALSE , $15.09 , $34.54 , $13.58 , $21.59 ," $(2,192,011.54)"," $793,129.46 ", $9.04 , $8.64 , $3.58 ,"GPMF. High temperature 85 degrees fahrenheit with 1.20"" rain.",,,,,,,,,,,,,,
,11,FRI, 112 ," $1,732.64 ", 749 ," $28,058.50 ", 861 ," $29,791.14 ", 104 ," $1,546.74 ", 207 ," $7,341.00 ", 311 ," $8,887.74 ", 229 ," $3,454.60 ", 120 ," $4,089.00 ", 349 ," $7,543.60 ", 111 ," $1,674.84 ", 466 ," $17,428.00 ", 577 ," $19,102.84 "," 1,517 "," $20,287.55 ", 556 ," 1,542 "," 1,517 "," 3,615 "," $8,408.82 "," $56,916.50 "," $20,287.55 "," $85,612.87 ", -   , $-   , 1 , FALSE , FALSE , FALSE , FALSE , TRUE , FALSE , FALSE , FALSE , FALSE , FALSE , FALSE , 112 , FALSE , FALSE , FALSE , FALSE , FALSE , FALSE , 311 , FALSE , FALSE , FALSE , FALSE , FALSE , FALSE , 349 , FALSE , FALSE , FALSE , FALSE , FALSE , FALSE , 577 , FALSE , FALSE , FALSE , FALSE , FALSE , FALSE ," 1,517 ", FALSE , FALSE , FALSE , FALSE , FALSE , FALSE ," $28,058.50 ", FALSE , FALSE , FALSE , FALSE , FALSE , FALSE ," $8,887.74 ", FALSE , FALSE , FALSE , FALSE , FALSE , FALSE ," $7,543.60 ", FALSE , FALSE , FALSE , FALSE , FALSE , FALSE ," $19,102.84 ", FALSE , FALSE , FALSE , FALSE , FALSE , FALSE ," $20,287.55 ", FALSE , FALSE , $15.12 , $36.91 , $13.37 , $23.68 ," $(2,106,398.67)"," $878,742.33 ", $9.33 , $8.71 , $3.58 ,"GPMF. High temperature 90 degrees fahrenheit with 0.99"" rain.",,,,,,,,,,,,,,
,12,SAT, 39 , $578.50 ," 1,000 "," $43,488.50 "," 1,039 "," $44,067.00 ", 23 , $338.88 , 283 ," $11,167.00 ", 306 ," $11,505.88 ", 24 , $325.20 , 214 ," $8,628.30 ", 238 ," $8,953.50 ", 51 , $856.24 , 838 ," $36,950.50 ", 889 ," $37,806.74 "," 2,575 "," $35,463.69 ", 137 ," 2,335 "," 2,575 "," 5,047 "," $2,098.82 "," $100,234.30 "," $35,463.69 "," $137,796.81 ", -   , $-   , 1 , FALSE , FALSE , FALSE , FALSE , FALSE , TRUE , FALSE , FALSE , FALSE , FALSE , FALSE , FALSE , 39 , FALSE , FALSE , FALSE , FALSE , FALSE , FALSE , 306 , FALSE , FALSE , FALSE , FALSE , FALSE , FALSE , 238 , FALSE , FALSE , FALSE , FALSE , FALSE , FALSE , 889 , FALSE , FALSE , FALSE , FALSE , FALSE , FALSE ," 2,575 ", FALSE , FALSE , FALSE , FALSE , FALSE , FALSE ," $43,488.50 ", FALSE , FALSE , FALSE , FALSE , FALSE , FALSE ," $11,505.88 ", FALSE , FALSE , FALSE , FALSE , FALSE , FALSE ," $8,953.50 ", FALSE , FALSE , FALSE , FALSE , FALSE , FALSE ," $37,806.74 ", FALSE , FALSE , FALSE , FALSE , FALSE , FALSE ," $35,463.69 ", FALSE , $15.32 , $42.93 , $13.77 , $27.30 ," $(1,968,601.86)"," $1,016,539.14 ", $15.02 , $9.23 , $3.58 ,Harris events (2). Chicago Gospel Festival - Pritzker. BTN 10K & 5K - SF.  Chicago Fire - SF. High temperature 84 degrees fahrenheit.,,,,,,,,,,,,,,
,13,SUN, 32 , $494.00 , 896 ," $38,737.00 ", 928 ," $39,231.00 ", 39 , $586.50 , 239 ," $10,460.00 ", 278 ," $11,046.50 ", 15 , $285.70 , 179 ," $7,586.00 ", 194 ," $7,871.70 ", 38 , $554.26 , 592 ," $25,384.00 ", 630 ," $25,938.26 "," 2,066 "," $31,289.16 ", 124 ," 1,906 "," 2,066 "," 4,096 "," $1,920.46 "," $82,167.00 "," $31,289.16 "," $115,376.62 ", -   , $-   , 1 , FALSE , FALSE , FALSE , FALSE , FALSE , FALSE , TRUE , FALSE , FALSE , FALSE , FALSE , FALSE , FALSE , 32 , FALSE , FALSE , FALSE , FALSE , FALSE , FALSE , 278 , FALSE , FALSE , FALSE , FALSE , FALSE , FALSE , 194 , FALSE , FALSE , FALSE , FALSE , FALSE , FALSE , 630 , FALSE , FALSE , FALSE , FALSE , FALSE , FALSE ," 2,066 ", FALSE , FALSE , FALSE , FALSE , FALSE , FALSE ," $38,737.00 ", FALSE , FALSE , FALSE , FALSE , FALSE , FALSE ," $11,046.50 ", FALSE , FALSE , FALSE , FALSE , FALSE , FALSE ," $7,871.70 ", FALSE , FALSE , FALSE , FALSE , FALSE , FALSE ," $25,938.26 ", FALSE , FALSE , FALSE , FALSE , FALSE , FALSE ," $31,289.16 ", $15.49 , $43.11 , $15.14 , $28.17 ," $(1,853,225.24)"," $1,131,915.76 ", $12.57 , $9.49 , $3.58 ,Harris event. High temperature 81 degrees fahrenheit.,,,,,,,,,,,,,,
,14,MON, 187 ," $2,837.00 ", 624 ," $22,519.00 ", 811 ," $25,356.00 ", 174 ," $2,542.81 ", 167 ," $5,626.00 ", 341 ," $8,168.81 ", 279 ," $4,170.50 ", 111 ," $3,221.80 ", 390 ," $7,392.30 ", 84 ," $1,201.90 ", 385 ," $14,885.00 ", 469 ," $16,086.90 "," 1,558 "," $24,218.10 ", 724 ," 1,287 "," 1,558 "," 3,569 "," $10,752.21 "," $46,251.80 "," $24,218.10 "," $81,222.11 ", -   , $-   , 1 , TRUE , FALSE , FALSE , FALSE , FALSE , FALSE , FALSE , 187 , FALSE , FALSE , FALSE , FALSE , FALSE , FALSE , 341 , FALSE , FALSE , FALSE , FALSE , FALSE , FALSE , 390 , FALSE , FALSE , FALSE , FALSE , FALSE , FALSE , 469 , FALSE , FALSE , FALSE , FALSE , FALSE , FALSE ," 1,558 ", FALSE , FALSE , FALSE , FALSE , FALSE , FALSE ," $22,519.00 ", FALSE , FALSE , FALSE , FALSE , FALSE , FALSE ," $8,168.81 ", FALSE , FALSE , FALSE , FALSE , FALSE , FALSE ," $7,392.30 ", FALSE , FALSE , FALSE , FALSE , FALSE , FALSE ," $16,086.90 ", FALSE , FALSE , FALSE , FALSE , FALSE , FALSE ," $24,218.10 ", FALSE , FALSE , FALSE , FALSE , FALSE , FALSE , $14.85 , $35.94 , $15.54 , $22.76 ," $(1,772,003.13)"," $1,213,137.87 ", $8.85 , $9.44 , $3.58 ,MP Summer Music Series. High temperature 87 degrees fahrenheit. Air quality alert from noon Monday to Wednesday midnight.,,,,,,,,,,,,,,
,15,TUE, 235 ," $3,587.76 ", 584 ," $20,176.50 ", 819 ," $23,764.26 ", 239 ," $3,517.14 ", 152 ," $5,111.06 ", 391 ," $8,628.20 ", 395 ," $6,085.70 ", 117 ," $3,332.20 ", 512 ," $9,417.90 ", 127 ," $1,851.92 ", 311 ," $11,592.50 ", 438 ," $13,444.42 "," 1,339 "," $17,984.74 ", 996 ," 1,164 "," 1,339 "," 3,499 "," $15,042.52 "," $40,212.26 "," $17,984.74 "," $73,239.52 ", -   , $-   , 1 , FALSE , TRUE , FALSE , FALSE , FALSE , FALSE , FALSE , FALSE , 235 , FALSE , FALSE , FALSE , FALSE , FALSE , FALSE , 391 , FALSE , FALSE , FALSE , FALSE , FALSE , FALSE , 512 , FALSE , FALSE , FALSE , FALSE , FALSE , FALSE , 438 , FALSE , FALSE , FALSE , FALSE , FALSE , FALSE ," 1,339 ", FALSE , FALSE , FALSE , FALSE , FALSE , FALSE ," $20,176.50 ", FALSE , FALSE , FALSE , FALSE , FALSE , FALSE ," $8,628.20 ", FALSE , FALSE , FALSE , FALSE , FALSE , FALSE ," $9,417.90 ", FALSE , FALSE , FALSE , FALSE , FALSE , FALSE ," $13,444.42 ", FALSE , FALSE , FALSE , FALSE , FALSE , FALSE ," $17,984.74 ", FALSE , FALSE , FALSE , FALSE , FALSE , $15.10 , $34.55 , $13.43 , $20.93 ," $(1,698,763.61)"," $1,286,377.39 ", $7.98 , $9.35 , $3.54 ,MP Summer Film Series - Indiana Jones and the Last Crusade. High temperature 91 degrees fahrenheit. Air quality alert in effect.,,,,,,,,,,,,,,
,16,WED, 231 ," $3,588.78 ", 595 ," $20,602.00 ", 826 ," $24,190.78 ", 236 ," $3,470.80 ", 203 ," $6,189.94 ", 439 ," $9,660.74 ", 403 ," $6,108.15 ", 147 ," $4,340.00 ", 550 ," $10,448.15 ", 181 ," $2,367.20 ", 347 ," $13,687.50 ", 528 ," $16,054.70 "," 1,460 "," $19,539.58 "," 1,051 "," 1,292 "," 1,460 "," 3,803 "," $15,534.93 "," $44,819.44 "," $19,539.58 "," $79,893.95 ", -   , $-   , 1 , FALSE , FALSE , TRUE , FALSE , FALSE , FALSE , FALSE , FALSE , FALSE , 231 , FALSE , FALSE , FALSE , FALSE , FALSE , FALSE , 439 , FALSE , FALSE , FALSE , FALSE , FALSE , FALSE , 550 , FALSE , FALSE , FALSE , FALSE , FALSE , FALSE , 528 , FALSE , FALSE , FALSE , FALSE , FALSE , FALSE ," 1,460 ", FALSE , FALSE , FALSE , FALSE , FALSE , FALSE ," $20,602.00 ", FALSE , FALSE , FALSE , FALSE , FALSE , FALSE ," $9,660.74 ", FALSE , FALSE , FALSE , FALSE , FALSE , FALSE ," $10,448.15 ", FALSE , FALSE , FALSE , FALSE , FALSE , FALSE ," $16,054.70 ", FALSE , FALSE , FALSE , FALSE , FALSE , FALSE ," $19,539.58 ", FALSE , FALSE , FALSE , FALSE , $14.78 , $34.69 , $13.38 , $21.01 ," $(1,618,869.66)"," $1,366,271.34 ", $8.71 , $9.31 , $3.54 ,"GPMF. High temperature 90 degrees fahrenheit with 0.36"" rain. Air quality alert in effect until midnight. Severe thunderstorm watch 12:30 - 8pm.",,,,,,,,,,,,,,
,17,THU, 212 ," $3,180.80 ", 776 ," $28,201.00 ", 988 ," $31,381.80 ", 176 ," $2,614.44 ", 245 ," $8,476.00 ", 421 ," $11,090.44 ", 321 ," $4,784.02 ", 148 ," $4,498.00 ", 469 ," $9,282.02 ", 139 ," $2,039.06 ", 535 ," $20,446.50 ", 674 ," $22,485.56 "," 2,033 "," $26,734.03 ", 848 ," 1,704 "," 2,033 "," 4,585 "," $12,618.32 "," $61,621.50 "," $26,734.03 "," $100,973.85 ", -   , $-   , 1 , FALSE , FALSE , FALSE , TRUE , FALSE , FALSE , FALSE , FALSE , FALSE , FALSE , 212 , FALSE , FALSE , FALSE , FALSE , FALSE , FALSE , 421 , FALSE , FALSE , FALSE , FALSE , FALSE , FALSE , 469 , FALSE , FALSE , FALSE , FALSE , FALSE , FALSE , 674 , FALSE , FALSE , FALSE , FALSE , FALSE , FALSE ," 2,033 ", FALSE , FALSE , FALSE , FALSE , FALSE , FALSE ," $28,201.00 ", FALSE , FALSE , FALSE , FALSE , FALSE , FALSE ," $11,090.44 ", FALSE , FALSE , FALSE , FALSE , FALSE , FALSE ," $9,282.02 ", FALSE , FALSE , FALSE , FALSE , FALSE , FALSE ," $22,485.56 ", FALSE , FALSE , FALSE , FALSE , FALSE , FALSE ," $26,734.03 ", FALSE , FALSE , FALSE , $14.88 , $36.16 , $13.15 , $22.02 ," $(1,517,895.81)"," $1,467,245.19 ", $11.00 , $9.41 , $3.54 ,MP Summer Music Series. High temperature 72 degrees fahrenheit.,,,,,,,,,,,,,,
,18,FRI, 150 ," $2,350.42 "," 1,013 "," $40,191.00 "," 1,163 "," $42,541.42 ", 104 ," $1,573.05 ", 312 ," $11,376.00 ", 416 ," $12,949.05 ", 204 ," $3,044.12 ", 244 ," $8,673.00 ", 448 ," $11,717.12 ", 155 ," $2,274.84 ", 674 ," $26,704.50 ", 829 ," $28,979.34 "," 2,165 "," $30,406.87 ", 613 ," 2,243 "," 2,165 "," 5,021 "," $9,242.43 "," $86,944.50 "," $30,406.87 "," $126,593.80 ", -   , $-   , 1 , FALSE , FALSE , FALSE , FALSE , TRUE , FALSE , FALSE , FALSE , FALSE , FALSE , FALSE , 150 , FALSE , FALSE , FALSE , FALSE , FALSE , FALSE , 416 , FALSE , FALSE , FALSE , FALSE , FALSE , FALSE , 448 , FALSE , FALSE , FALSE , FALSE , FALSE , FALSE , 829 , FALSE , FALSE , FALSE , FALSE , FALSE , FALSE ," 2,165 ", FALSE , FALSE , FALSE , FALSE , FALSE , FALSE ," $40,191.00 ", FALSE , FALSE , FALSE , FALSE , FALSE , FALSE ," $12,949.05 ", FALSE , FALSE , FALSE , FALSE , FALSE , FALSE ," $11,717.12 ", FALSE , FALSE , FALSE , FALSE , FALSE , FALSE ," $28,979.34 ", FALSE , FALSE , FALSE , FALSE , FALSE , FALSE ," $30,406.87 ", FALSE , FALSE , $15.08 , $38.76 , $14.04 , $25.21 ," $(1,391,302.01)"," $1,593,838.99 ", $13.80 , $9.65 , $3.54 ,GPMF. BlackPink 2025 World Tour - SF. High temperature 80 degrees fahrenheit.,,,,,,,,,,,,,,
,19,SAT, 40 , $629.76 ," 1,172 "," $51,168.00 "," 1,212 "," $51,797.76 ", 47 , $713.75 , 347 ," $14,978.00 ", 394 ," $15,691.75 ", 24 , $347.66 , 212 ," $8,726.50 ", 236 ," $9,074.16 ", 89 ," $1,279.62 ", 998 ," $41,503.50 "," 1,087 "," $42,783.12 "," 3,055 "," $43,797.16 ", 200 ," 2,729 "," 3,055 "," 5,984 "," $2,970.79 "," $116,376.00 "," $43,797.16 "," $163,143.95 ", -   , $-   , 1 , FALSE , FALSE , FALSE , FALSE , FALSE , TRUE , FALSE , FALSE , FALSE , FALSE , FALSE , FALSE , 40 , FALSE , FALSE , FALSE , FALSE , FALSE , FALSE , 394 , FALSE , FALSE , FALSE , FALSE , FALSE , FALSE , 236 , FALSE , FALSE , FALSE , FALSE , FALSE , FALSE ," 1,087 ", FALSE , FALSE , FALSE , FALSE , FALSE , FALSE ," 3,055 ", FALSE , FALSE , FALSE , FALSE , FALSE , FALSE ," $51,168.00 ", FALSE , FALSE , FALSE , FALSE , FALSE , FALSE ," $15,691.75 ", FALSE , FALSE , FALSE , FALSE , FALSE , FALSE ," $9,074.16 ", FALSE , FALSE , FALSE , FALSE , FALSE , FALSE ," $42,783.12 ", FALSE , FALSE , FALSE , FALSE , FALSE , FALSE ," $43,797.16 ", FALSE , $14.85 , $42.64 , $14.34 , $27.26 ," $(1,228,158.06)"," $1,756,982.94 ", $17.78 , $10.08 , $3.54 ,"CSO, Harris events. GPMF.  High temperature 83 degrees fahrenheit with 0.19"" rain.",,,,,,,,,,,,,,
,20,SUN, 29 , $547.50 , 928 ," $40,130.00 ", 957 ," $40,677.50 ", 13 , $199.64 , 226 ," $10,276.00 ", 239 ," $10,475.64 ", 18 , $251.30 , 162 ," $6,703.00 ", 180 ," $6,954.30 ", 31 , $431.50 , 754 ," $31,253.00 ", 785 ," $31,684.50 "," 1,872 "," $29,938.02 ", 91 ," 2,070 "," 1,872 "," 4,033 "," $1,429.94 "," $88,362.00 "," $29,938.02 "," $119,729.96 ", -   , $-   , 1 , FALSE , FALSE , FALSE , FALSE , FALSE , FALSE , TRUE , FALSE , FALSE , FALSE , FALSE , FALSE , FALSE , 29 , FALSE , FALSE , FALSE , FALSE , FALSE , FALSE , 239 , FALSE , FALSE , FALSE , FALSE , FALSE , FALSE , 180 , FALSE , FALSE , FALSE , FALSE , FALSE , FALSE , 785 , FALSE , FALSE , FALSE , FALSE , FALSE , FALSE ," 1,872 ", FALSE , FALSE , FALSE , FALSE , FALSE , FALSE ," $40,130.00 ", FALSE , FALSE , FALSE , FALSE , FALSE , FALSE ," $10,475.64 ", FALSE , FALSE , FALSE , FALSE , FALSE , FALSE ," $6,954.30 ", FALSE , FALSE , FALSE , FALSE , FALSE , FALSE ," $31,684.50 ", FALSE , FALSE , FALSE , FALSE , FALSE , FALSE ," $29,938.02 ", $15.71 , $42.69 , $15.99 , $29.69 ," $(1,108,428.10)"," $1,876,712.90 ", $13.05 , $10.23 , $3.54 ,Harris event. High temperature 75 degrees fahrenheit.,,,,,,,,,,,,,,
,21,MON, 213 ," $3,242.14 ", 734 ," $27,353.00 ", 947 ," $30,595.14 ", 161 ," $2,317.99 ", 185 ," $6,480.00 ", 346 ," $8,797.99 ", 264 ," $3,924.00 ", 134 ," $4,635.00 ", 398 ," $8,559.00 ", 81 ," $1,165.34 ", 449 ," $17,277.00 ", 530 ," $18,442.34 "," 1,622 "," $25,866.05 ", 719 ," 1,502 "," 1,622 "," 3,843 "," $10,649.47 "," $55,745.00 "," $25,866.05 "," $92,260.52 ", -   , $-   , 1 , TRUE , FALSE , FALSE , FALSE , FALSE , FALSE , FALSE , 213 , FALSE , FALSE , FALSE , FALSE , FALSE , FALSE , 346 , FALSE , FALSE , FALSE , FALSE , FALSE , FALSE , 398 , FALSE , FALSE , FALSE , FALSE , FALSE , FALSE , 530 , FALSE , FALSE , FALSE , FALSE , FALSE , FALSE ," 1,622 ", FALSE , FALSE , FALSE , FALSE , FALSE , FALSE ," $27,353.00 ", FALSE , FALSE , FALSE , FALSE , FALSE , FALSE ," $8,797.99 ", FALSE , FALSE , FALSE , FALSE , FALSE , FALSE ," $8,559.00 ", FALSE , FALSE , FALSE , FALSE , FALSE , FALSE ," $18,442.34 ", FALSE , FALSE , FALSE , FALSE , FALSE , FALSE ," $25,866.05 ", FALSE , FALSE , FALSE , FALSE , FALSE , FALSE , $14.81 , $37.11 , $15.95 , $24.01 ," $(1,016,167.58)"," $1,968,973.42 ", $10.05 , $10.22 , $3.54 ,MP Summer Music Series. High temperature 82 degrees fahrenheit.,,,,,,,,,,,,,,
,22,TUE, 225 ," $3,380.28 ", 686 ," $24,140.00 ", 911 ," $27,520.28 ", 213 ," $3,109.90 ", 228 ," $6,197.00 ", 441 ," $9,306.90 ", 402 ," $6,017.80 ", 140 ," $4,460.70 ", 542 ," $10,478.50 ", 117 ," $1,946.74 ", 434 ," $16,539.00 ", 551 ," $18,485.74 "," 1,717 "," $23,732.11 ", 957 ," 1,488 "," 1,717 "," 4,162 "," $14,454.72 "," $51,336.70 "," $23,732.11 "," $89,523.53 ", -   , $-   , 1 , FALSE , TRUE , FALSE , FALSE , FALSE , FALSE , FALSE , FALSE , 225 , FALSE , FALSE , FALSE , FALSE , FALSE , FALSE , 441 , FALSE , FALSE , FALSE , FALSE , FALSE , FALSE , 542 , FALSE , FALSE , FALSE , FALSE , FALSE , FALSE , 551 , FALSE , FALSE , FALSE , FALSE , FALSE , FALSE ," 1,717 ", FALSE , FALSE , FALSE , FALSE , FALSE , FALSE ," $24,140.00 ", FALSE , FALSE , FALSE , FALSE , FALSE , FALSE ," $9,306.90 ", FALSE , FALSE , FALSE , FALSE , FALSE , FALSE ," $10,478.50 ", FALSE , FALSE , FALSE , FALSE , FALSE , FALSE ," $18,485.74 ", FALSE , FALSE , FALSE , FALSE , FALSE , FALSE ," $23,732.11 ", FALSE , FALSE , FALSE , FALSE , FALSE , $15.10 , $34.50 , $13.82 , $21.51 ," $(926,644.05)"," $2,058,496.95 ", $9.76 , $10.20 , $3.47 ,MP Summer Film Series - Love and Basketball. High temperature 86 degrees fahrenheit.,,,,,,,,,,,,,,
,23,WED, 235 ," $3,615.30 ", 654 ," $22,687.00 ", 889 ," $26,302.30 ", 215 ," $3,181.49 ", 216 ," $7,480.50 ", 431 ," $10,661.99 ", 411 ," $6,224.12 ", 159 ," $4,779.00 ", 570 ," $11,003.12 ", 184 ," $2,678.12 ", 388 ," $14,501.00 ", 572 ," $17,179.12 "," 1,793 "," $24,388.29 "," 1,045 "," 1,417 "," 1,793 "," 4,255 "," $15,699.03 "," $49,447.50 "," $24,388.29 "," $89,534.82 ", -   , $-   , 1 , FALSE , FALSE , TRUE , FALSE , FALSE , FALSE , FALSE , FALSE , FALSE , 235 , FALSE , FALSE , FALSE , FALSE , FALSE , FALSE , 431 , FALSE , FALSE , FALSE , FALSE , FALSE , FALSE , 570 , FALSE , FALSE , FALSE , FALSE , FALSE , FALSE , 572 , FALSE , FALSE , FALSE , FALSE , FALSE , FALSE ," 1,793 ", FALSE , FALSE , FALSE , FALSE , FALSE , FALSE ," $22,687.00 ", FALSE , FALSE , FALSE , FALSE , FALSE , FALSE ," $10,661.99 ", FALSE , FALSE , FALSE , FALSE , FALSE , FALSE ," $11,003.12 ", FALSE , FALSE , FALSE , FALSE , FALSE , FALSE ," $17,179.12 ", FALSE , FALSE , FALSE , FALSE , FALSE , FALSE ," $24,388.29 ", FALSE , FALSE , FALSE , FALSE , $15.02 , $34.90 , $13.60 , $21.04 ," $(837,109.23)"," $2,148,031.77 ", $9.76 , $10.18 , $3.47 ,GPMF. High temperature 94 degrees fahrenheit.Heat advisory in effect from 10 AM to Thursday 10 PM. Heat index values of 100 to 107 expected.,,,,,,,,,,,,,,
 ,24,THU, 220 ," $3,379.52 ", 722 ," $25,558.00 ", 942 ," $28,937.52 ", 181 ," $2,663.80 ", 245 ," $8,300.50 ", 426 ," $10,964.30 ", 313 ," $4,626.40 ", 134 ," $3,819.70 ", 447 ," $8,446.10 ", 103 ," $1,477.96 ", 386 ," $14,266.00 ", 489 ," $15,743.96 "," 1,578 "," $21,322.92 ", 817 ," 1,487 "," 1,578 "," 3,882 "," $12,147.68 "," $51,944.20 "," $21,322.92 "," $85,414.80 ", -   , $-   , 1 , FALSE , FALSE , FALSE , TRUE , FALSE , FALSE , FALSE , FALSE , FALSE , FALSE , 220 , FALSE , FALSE , FALSE , FALSE , FALSE , FALSE , 426 , FALSE , FALSE , FALSE , FALSE , FALSE , FALSE , 447 , FALSE , FALSE , FALSE , FALSE , FALSE , FALSE , 489 , FALSE , FALSE , FALSE , FALSE , FALSE , FALSE ," 1,578 ", FALSE , FALSE , FALSE , FALSE , FALSE , FALSE ," $25,558.00 ", FALSE , FALSE , FALSE , FALSE , FALSE , FALSE ," $10,964.30 ", FALSE , FALSE , FALSE , FALSE , FALSE , FALSE ," $8,446.10 ", FALSE , FALSE , FALSE , FALSE , FALSE , FALSE ," $15,743.96 ", FALSE , FALSE , FALSE , FALSE , FALSE , FALSE ," $21,322.92 ", FALSE , FALSE , FALSE , $14.87 , $34.93 , $13.51 , $22.00 ," $(751,694.43)"," $2,233,446.57 ", $9.31 , $10.14 , $3.47 ,"MP Summer Music Series. High temperature 92 degrees fahrenheit with 0.03"" rain.Heat advisory in effect from 10 AM to Thursday 10 PM. Heat index values of 100 to 107 expected.",,,,,,,,,,,,,,
,25,FRI, 132 ," $2,005.06 ", 780 ," $29,677.00 ", 912 ," $31,682.06 ", 97 ," $1,453.24 ", 213 ," $7,757.00 ", 310 ," $9,210.24 ", 188 ," $2,832.42 ", 128 ," $3,922.00 ", 316 ," $6,754.42 ", 129 ," $1,921.36 ", 567 ," $22,403.50 ", 696 ," $24,324.86 "," 1,673 "," $22,050.54 ", 546 ," 1,688 "," 1,673 "," 3,907 "," $8,212.08 "," $63,759.50 "," $22,050.54 "," $94,022.12 ", -   , $-   , 1 , FALSE , FALSE , FALSE , FALSE , TRUE , FALSE , FALSE , FALSE , FALSE , FALSE , FALSE , 132 , FALSE , FALSE , FALSE , FALSE , FALSE , FALSE , 310 , FALSE , FALSE , FALSE , FALSE , FALSE , FALSE , 316 , FALSE , FALSE , FALSE , FALSE , FALSE , FALSE , 696 , FALSE , FALSE , FALSE , FALSE , FALSE , FALSE ," 1,673 ", FALSE , FALSE , FALSE , FALSE , FALSE , FALSE ," $29,677.00 ", FALSE , FALSE , FALSE , FALSE , FALSE , FALSE ," $9,210.24 ", FALSE , FALSE , FALSE , FALSE , FALSE , FALSE ," $6,754.42 ", FALSE , FALSE , FALSE , FALSE , FALSE , FALSE ," $24,324.86 ", FALSE , FALSE , FALSE , FALSE , FALSE , FALSE ," $22,050.54 ", FALSE , FALSE , $15.04 , $37.77 , $13.18 , $24.07 ," $(657,672.31)"," $2,327,468.69 ", $10.25 , $10.15 , $3.47 ,"GPMF. High temperature 83 degrees fahrenheit with 0.01"" rain.",,,,,,,,,,,,,,
,26,SAT, 34 , $516.26 ," 1,018 "," $43,654.00 "," 1,052 "," $44,170.26 ", 29 , $439.65 , 324 ," $13,797.25 ", 353 ," $14,236.90 ", 23 , $301.16 , 150 ," $6,317.00 ", 173 ," $6,618.16 ", 83 ," $1,336.92 ", 763 ," $32,670.00 ", 846 ," $34,006.92 "," 2,185 "," $29,589.41 ", 169 ," 2,255 "," 2,185 "," 4,609 "," $2,593.99 "," $96,438.25 "," $29,589.41 "," $128,621.65 ", -   , $-   , 1 , FALSE , FALSE , FALSE , FALSE , FALSE , TRUE , FALSE , FALSE , FALSE , FALSE , FALSE , FALSE , 34 , FALSE , FALSE , FALSE , FALSE , FALSE , FALSE , 353 , FALSE , FALSE , FALSE , FALSE , FALSE , FALSE , 173 , FALSE , FALSE , FALSE , FALSE , FALSE , FALSE , 846 , FALSE , FALSE , FALSE , FALSE , FALSE , FALSE ," 2,185 ", FALSE , FALSE , FALSE , FALSE , FALSE , FALSE ," $43,654.00 ", FALSE , FALSE , FALSE , FALSE , FALSE , FALSE ," $14,236.90 ", FALSE , FALSE , FALSE , FALSE , FALSE , FALSE ," $6,618.16 ", FALSE , FALSE , FALSE , FALSE , FALSE , FALSE ," $34,006.92 ", FALSE , FALSE , FALSE , FALSE , FALSE , FALSE ," $29,589.41 ", FALSE , $15.35 , $42.77 , $13.54 , $27.91 ," $(529,050.66)"," $2,456,090.34 ", $14.02 , $10.29 , $3.47 ,"GPMF. Chicago Fire - SF. High temperature 83 degrees fahrenheit with 0.02"" rain.",,,,,,,,,,,,,,
,27,SUN, 27 , $452.50 , 968 ," $41,246.00 ", 995 ," $41,698.50 ", 11 , $163.97 , 212 ," $9,470.00 ", 223 ," $9,633.97 ", 17 , $224.06 , 166 ," $7,015.50 ", 183 ," $7,239.56 ", 32 , $456.18 , 597 ," $25,001.50 ", 629 ," $25,457.68 "," 1,937 "," $31,956.98 ", 87 ," 1,943 "," 1,937 "," 3,967 "," $1,296.71 "," $82,733.00 "," $31,956.98 "," $115,986.69 ", -   , $-   , 1 , FALSE , FALSE , FALSE , FALSE , FALSE , FALSE , TRUE , FALSE , FALSE , FALSE , FALSE , FALSE , FALSE , 27 , FALSE , FALSE , FALSE , FALSE , FALSE , FALSE , 223 , FALSE , FALSE , FALSE , FALSE , FALSE , FALSE , 183 , FALSE , FALSE , FALSE , FALSE , FALSE , FALSE , 629 , FALSE , FALSE , FALSE , FALSE , FALSE , FALSE ," 1,937 ", FALSE , FALSE , FALSE , FALSE , FALSE , FALSE ," $41,246.00 ", FALSE , FALSE , FALSE , FALSE , FALSE , FALSE ," $9,633.97 ", FALSE , FALSE , FALSE , FALSE , FALSE , FALSE ," $7,239.56 ", FALSE , FALSE , FALSE , FALSE , FALSE , FALSE ," $25,457.68 ", FALSE , FALSE , FALSE , FALSE , FALSE , FALSE ," $31,956.98 ", $14.90 , $42.58 , $16.50 , $29.24 ," $(413,063.97)"," $2,572,077.03 ", $12.64 , $10.38 , $3.47 ,"Columbus closed south of Monroe for Lollapalooza.High temperature 88 degrees fahrenheit with 0.04"" rain.",,,,,,,,,,,,,,
,28,MON, 185 ," $2,825.02 ", 692 ," $25,116.00 ", 877 ," $27,941.02 ", 179 ," $2,564.54 ", 219 ," $7,489.00 ", 398 ," $10,053.54 ", 275 ," $4,112.10 ", 107 ," $3,349.00 ", 382 ," $7,461.10 ", 75 ," $1,067.92 ", 392 ," $14,944.50 ", 467 ," $16,012.42 "," 1,424 "," $19,469.00 ", 714 ," 1,410 "," 1,424 "," 3,548 "," $10,569.58 "," $50,898.50 "," $19,469.00 "," $80,937.08 ", -   , $-   , 1 , TRUE , FALSE , FALSE , FALSE , FALSE , FALSE , FALSE , 185 , FALSE , FALSE , FALSE , FALSE , FALSE , FALSE , 398 , FALSE , FALSE , FALSE , FALSE , FALSE , FALSE , 382 , FALSE , FALSE , FALSE , FALSE , FALSE , FALSE , 467 , FALSE , FALSE , FALSE , FALSE , FALSE , FALSE ," 1,424 ", FALSE , FALSE , FALSE , FALSE , FALSE , FALSE ," $25,116.00 ", FALSE , FALSE , FALSE , FALSE , FALSE , FALSE ," $10,053.54 ", FALSE , FALSE , FALSE , FALSE , FALSE , FALSE ," $7,461.10 ", FALSE , FALSE , FALSE , FALSE , FALSE , FALSE ," $16,012.42 ", FALSE , FALSE , FALSE , FALSE , FALSE , FALSE ," $19,469.00 ", FALSE , FALSE , FALSE , FALSE , FALSE , FALSE , $14.80 , $36.10 , $13.67 , $22.81 ," $(332,126.89)"," $2,653,014.11 ", $8.82 , $10.33 , $3.47 ,"Columbus closed south of Monroe for Lollapalooza. MP Summer Music Series. High temperature 92 degrees fahrenheit with 0.03"" rain. Heat advisory Monday noon to 8 pm. Heat indexes of 105 to 109 expected.",,,,,,,,,,,,,,
,29,TUE, 208 ," $3,174.02 ", 614 ," $21,502.00 ", 822 ," $24,676.02 ", 232 ," $3,585.45 ", 131 ," $3,887.00 ", 363 ," $7,472.45 ", 401 ," $6,061.40 ", 122 ," $3,233.00 ", 523 ," $9,294.40 ", 105 ," $1,503.32 ", 313 ," $11,632.50 ", 418 ," $13,135.82 "," 1,421 "," $19,589.64 ", 946 ," 1,180 "," 1,421 "," 3,547 "," $14,324.19 "," $40,254.50 "," $19,589.64 "," $74,168.33 ", -   , $-   , 1 , FALSE , TRUE , FALSE , FALSE , FALSE , FALSE , FALSE , FALSE , 208 , FALSE , FALSE , FALSE , FALSE , FALSE , FALSE , 363 , FALSE , FALSE , FALSE , FALSE , FALSE , FALSE , 523 , FALSE , FALSE , FALSE , FALSE , FALSE , FALSE , 418 , FALSE , FALSE , FALSE , FALSE , FALSE , FALSE ," 1,421 ", FALSE , FALSE , FALSE , FALSE , FALSE , FALSE ," $21,502.00 ", FALSE , FALSE , FALSE , FALSE , FALSE , FALSE ," $7,472.45 ", FALSE , FALSE , FALSE , FALSE , FALSE , FALSE ," $9,294.40 ", FALSE , FALSE , FALSE , FALSE , FALSE , FALSE ," $13,135.82 ", FALSE , FALSE , FALSE , FALSE , FALSE , FALSE ," $19,589.64 ", FALSE , FALSE , FALSE , FALSE , FALSE , $15.14 , $34.11 , $13.79 , $20.91 ," $(257,958.56)"," $2,727,182.44 ", $8.08 , $10.25 , Pending ,Columbus closed south of Monroe for Lollapalooza.MP Summer Film Series - The Grand Budapest Hotel. High temperature 93 degrees fahrenheit.,,,,,,,,,,,,,,
,30,WED,,,,, - , $-   ,,,,, - , $-   ,,,,, -   , $-   ,,,,, - , $-   ,,, - , -   , -   , -   , $-   , $-   , $-   , $-   , -   , $-   , -   , FALSE , FALSE , FALSE , FALSE , FALSE , FALSE , FALSE , FALSE , FALSE , FALSE , FALSE , FALSE , FALSE , FALSE , FALSE , FALSE , FALSE , FALSE , FALSE , FALSE , FALSE , FALSE , FALSE , FALSE , FALSE , FALSE , FALSE , FALSE , FALSE , FALSE , FALSE , FALSE , FALSE , FALSE , FALSE , FALSE , FALSE , FALSE , FALSE , FALSE , FALSE , FALSE , FALSE , FALSE , FALSE , FALSE , FALSE , FALSE , FALSE , FALSE , FALSE , FALSE , FALSE , FALSE , FALSE , FALSE , FALSE , FALSE , FALSE , FALSE , FALSE , FALSE , FALSE , FALSE , FALSE , FALSE , FALSE , FALSE , FALSE , FALSE , FALSE , FALSE , FALSE , FALSE , FALSE , FALSE , FALSE , $-   , $-   , $-   , --- , --- , --- , $-   , --- ,,,,,,,,,,,,,,,,
,31,THU,,,,, - , $-   ,,,,, - , $-   ,,,,, -   , $-   ,,,,, - , $-   ,,, - , -   , -   , -   , $-   , $-   , $-   , $-   , -   , $-   , -   , FALSE , FALSE , FALSE , FALSE , FALSE , FALSE , FALSE , FALSE , FALSE , FALSE , FALSE , FALSE , FALSE , FALSE , FALSE , FALSE , FALSE , FALSE , FALSE , FALSE , FALSE , FALSE , FALSE , FALSE , FALSE , FALSE , FALSE , FALSE , FALSE , FALSE , FALSE , FALSE , FALSE , FALSE , FALSE , FALSE , FALSE , FALSE , FALSE , FALSE , FALSE , FALSE , FALSE , FALSE , FALSE , FALSE , FALSE , FALSE , FALSE , FALSE , FALSE , FALSE , FALSE , FALSE , FALSE , FALSE , FALSE , FALSE , FALSE , FALSE , FALSE , FALSE , FALSE , FALSE , FALSE , FALSE , FALSE , FALSE , FALSE , FALSE , FALSE , FALSE , FALSE , FALSE , FALSE , FALSE , FALSE , $-   , $-   , $-   , --- , --- , --- , $-   , --- ,,,,,,,,,,,,,,,,
,,TOTALS," 4,113 "," 64,064.40 "," 23,006 "," $899,044.50 "," 27,119 "," $963,108.90 "," 3,423 "," $50,539.62 "," 5,524 "," $201,604.29 "," 8,947 "," $252,143.91 "," 6,250 "," $93,923.40 "," 3,768 "," $129,515.41 "," 10,018 "," $223,438.81 "," 2,888 "," $42,327.56 "," 13,217 "," $529,213.14 "," 16,105 "," $571,540.70 "," 48,323 "," $716,950.12 "," 16,674 "," 45,515 "," 48,323 "," 110,512 "," $250,855 "," $1,759,377 "," $716,950 "," $2,727,182.44 ", -   , $-   , 29 ,,,,,,,,,,,,,,,,,,,,,,,,,,,,,,,,,,,,,,,,,,,,,,,,,,,,,,,,,,,,,,,,,,,,,,,,,,,,,, $15.04 , $38.65 , $14.84 , $24.68 , Budget , Reforecast ,,,,,,,,,,,,,,,,,,
,Daily Averages,,Units,,,Revenue,Units,Revenue,,,,,Units,Revenue,,,,,Units,Revenue,,,,,Units,Revenue,Units,Revenue,,,Online Units,,,,Online Rev, Total Gross - Actual ,,,,,,,,,,,,,,,,,,,,,,,,,,,,,,,,,,,,,,,,,,,,,,,,,,,,,,,,,,,,,,,,,,,,,,,,,,,,,,,,,,,,," $2,727,182.44 "," $2,727,182.44 ",,,,,,,,,,,,,,,,,,
,Monday,, 189 ,,," $26,037.00 ", 189 ," $26,037.00 "," $21,189.50 ",,,, 330 ," $8,516.26 ",,,,, 361 ," $7,112.78 ",,,,, 442 ," $15,026.79 "," 1,538 "," $22,716.52 ",,," 1,538 ",,,," $22,716.52 ", Total Gross - Budget ,,,,,,,,,,,,,,,,,,,,,,,,,,,,,,,,,,,,,,,,,,,,,,,,,,,,,,,,,,,,,,,,,,,,,,,,,,,,,,,,,,,,," $2,985,141.00 ", $-   ,,,,,,,,,,,,,,,,,,
,Tuesday,, 219 ,,," $21,189.50 ", 219 ," $21,189.50 "," $22,409.13 ",,,, 359 ," $7,812.79 ",,,,, 497 ," $9,226.45 ",,,,, 435 ," $13,946.96 "," 1,379 "," $18,699.63 ",,," 1,379 ",,,," $18,699.63 ",Over/(Short),,,,,,,,,,,,,,,,,,,,,,,,,,,,,,,,,,,,,,,,,,,,,,,,,,,,,,,,,,,,,,,,,,,,,,,,,,,,,,,,,,,,," $(257,958.56)"," $2,727,182.44 ",,,,,,,,,,,,,,,,,,
,Wednesday,, 214 ,,," $22,409.13 ", 214 ," $22,409.13 "," $25,651.63 ",,,, 389 ," $9,150.94 ",,,,, 519 ," $9,954.24 ",,,,, 559 ," $16,883.70 "," 1,556 "," $21,215.35 ",,," 1,556 ",,,," $21,215.35 ",Daily Average - Actual,,,,,,,,,,,,,,,,,,,,,,,,,,,,,,,,,,,,,,,,,,,,,,,,,,,,,,,,,,,,,,,,,,,,,,,,,,,,,,,,,,,,," $94,040.77 "," $94,040.77 ",,,,,,,,,,,,,,,,,,
,Thursday,, 188 ,,," $25,651.63 ", 188 ," $25,651.63 "," $34,342.63 ",,,, 360 ," $9,595.99 ",,,,, 376 ," $7,224.26 ",,,,, 497 ," $15,879.21 "," 1,583 "," $21,541.08 ",,," 1,583 ",,,," $21,541.08 ",Daily Average - Budget,,,,,,,,,,,,,,,,,,,,,,,,,,,,,,,,,,,,,,,,,,,,,,,,,,,,,,,,,,,,,,,,,,,,,,,,,,,,,,,,,,,,," $96,294.87 ", $-   ,,,,,,,,,,,,,,,,,,
,Friday,, 103 ,,," $34,342.63 ", 103 ," $34,342.63 "," $48,628.63 ",,,, 261 ," $7,855.76 ",,,,, 289 ," $6,904.20 ",,,,, 593 ," $20,447.94 "," 1,610 "," $22,120.31 ",,," 1,610 ",,,," $22,120.31 ",Variance,,,,,,,,,,,,,,,,,,,,,,,,,,,,,,,,,,,,,,,,,,,,,,,,,,,,,,,,,,,,,,,,,,,,,,,,,,,,,,,,,,,,," $(2,254.10)"," $94,040.77 ",,,,,,,,,,,,,,,,,,
,Saturday,, 34 ,,," $48,628.63 ", 34 ," $48,628.63 "," $41,205.25 ",,,, 263 ," $10,358.63 ",,,,, 188 ," $7,164.31 ",,,,, 792 ," $32,421.08 "," 2,278 "," $34,708.54 ",,," 2,278 ",,,," $34,708.54 ",,,,,,,,,,,,,,,,,,,,,,,,,,,,,,,,,,,,,,,,,,,,,,,,,,,,,,,,,,,,,,,,,,,,,,,,,,,,,,,,,,,,,,,,,,,,,,,,,,,,,,,,,
,Sunday,, 26 ,,," $41,205.25 ", 26 ," $41,205.25 "," $8,516.26 ",,,, 185 ," $7,792.40 ",,,,, 151 ," $5,966.87 ",,,,, 601 ," $24,792.77 "," 1,792 "," $33,561.19 ",,," 1,792 ",,,," $33,561.19 ",,,,,,,,,,,,,,,,,,,,,,,,,,,,,,,,,,,,,,,,,,,,,,,,,,,,,,,,,,,,,,,,,,,,,,,,,,,,,,,,,,,,,,,,,,,,,,,,,,,,,,,,,
,,,,,,,,,,,,,,,,,,,,,,,,,,,,,,,,,,,,,,,,,,,,,,,,,,,,,,,,,,,,,,,,,,,,,,,,,,,,,,,,,,,,,,,,,,,,,,,,,,,,,,,,,,,,,,,,,,,,,,,,,,,,,,,,,,,,,,,,,,,,
,,,,,,,Drive Up & Flex Daily,,,,,,,,,,,,,,,,,,,,Online,,,,,,,,,,,,,,,,,,,,,,,,,,,,,,,,,,,,,,,,,,,,,,,,,,,,,,,,,,,,,,,,,,,,,,,,,,,,,,,,,,,,,,,,,,,,,,,,,,,,,,,,,,,,,,,,,
,Avg /Day,,,,,,GPN,GPS,,,,,MLG,MPG,,,,,ONLINE,,,,,,,, $14.77 ,,"Total (Online, Drive Up & Flex Daily) By Day",,Units,Revenue,Avg/Unit,,,,,,,,,,,,,,,,,,,,,,,,,,,,,,,,,,,,,,,,,,,,,,,,,,,,,,,,,,,,,,,,,,,,,,,,,,,,,,,,,,,,,,,,,,,,,,,,,,,,,,,,,,,
,Monday,,,,,, $137.76 , $25.85 ,,,,, $19.69 , $34.00 ,,,,, $14.77 ,,,,,,,, $13.56 ,,Monday,," 2,860 "," 79,409 ", $27.77 ,,,,,,,,,,,,,,,,,,,,,,,,,,,,,,,,,,,,,,,,,,,,,,,,,,,,,,,,,,,,,,,,,,,,,,,,,,,,,,,,,,,,,,,,,,,,,,,,,,,,,,,,,,,
,Tuesday,,,,,, $96.58 , $21.76 ,,,,, $18.56 , $32.06 ,,,,, $13.56 ,,,,,,,, $13.63 ,,Tuesday,," 2,889 "," 70,875 ", $24.53 ,,,,,,,,,,,,,,,,,,,,,,,,,,,,,,,,,,,,,,,,,,,,,,,,,,,,,,,,,,,,,,,,,,,,,,,,,,,,,,,,,,,,,,,,,,,,,,,,,,,,,,,,,,,
,Wednesday,,,,,, $104.84 , $23.55 ,,,,, $19.19 , $30.23 ,,,,, $13.63 ,,,,,,,, $13.61 ,,Wednesday,," 3,236 "," 79,613 ", $24.60 ,,,,,,,,,,,,,,,,,,,,,,,,,,,,,,,,,,,,,,,,,,,,,,,,,,,,,,,,,,,,,,,,,,,,,,,,,,,,,,,,,,,,,,,,,,,,,,,,,,,,,,,,,,,
,Thursday,,,,,, $136.44 , $26.64 ,,,,, $19.23 , $31.98 ,,,,, $13.61 ,,,,,,,, $13.74 ,,Thursday,," 3,004 "," 79,892 ", $26.60 ,,,,,,,,,,,,,,,,,,,,,,,,,,,,,,,,,,,,,,,,,,,,,,,,,,,,,,,,,,,,,,,,,,,,,,,,,,,,,,,,,,,,,,,,,,,,,,,,,,,,,,,,,,,
,Friday,,,,,, $332.62 , $30.07 ,,,,, $23.87 , $34.48 ,,,,, $13.74 ,,,,,,,, $15.24 ,,Friday,," 2,857 "," 91,671 ", $32.09 ,,,,,,,,,,,,,,,,,,,,,,,,,,,,,,,,,,,,,,,,,,,,,,,,,,,,,,,,,,,,,,,,,,,,,,,,,,,,,,,,,,,,,,,,,,,,,,,,,,,,,,,,,,,
,Saturday,,,,,," $1,430.25 ", $39.35 ,,,,, $38.21 , $40.95 ,,,,, $15.24 ,,,,,,,, $18.73 ,,Saturday,," 3,554 "," 133,281 ", $37.50 ,,,,,,,,,,,,,,,,,,,,,,,,,,,,,,,,,,,,,,,,,,,,,,,,,,,,,,,,,,,,,,,,,,,,,,,,,,,,,,,,,,,,,,,,,,,,,,,,,,,,,,,,,,,
,Sunday,,,,,," $1,584.82 ", $42.06 ,,,,, $39.58 , $41.27 ,,,,, $18.73 ,,,,,,,,,,Sunday,," 2,754 "," 113,318 ", $41.14 ,,,,,,,,,,,,,,,,,,,,,,,,,,,,,,,,,,,,,,,,,,,,,,,,,,,,,,,,,,,,,,,,,,,,,,,,,,,,,,,,,,,,,,,,,,,,,,,,,,,,,,,,,,,
,,,,,,,,,,,,,,,,,,,,,,,,,,,,,,,,,,,,,,,,,,,,,,,,,,,,,,,,,,,,,,,,,,,,,,,,,,,,,,,,,,,,,,,,,,,,,,,,,,,,,,,,,,,,,,,,,,,,,,,,,,,,,,,,,,,,,,,,,,,,
,,Previous Year Inputs,,,,,,,,,,,,,,,,,,,,,,,,,,,,,,,,,,,,,,,,,,,,,,,,,,,,,,,,,,,,,,,,,,,,,,,,,,,,,,,,,,,,,,,,,,,,,,,,,,,,,,,,,,,,,,,,,,,,,,,,,,,,,,,,,,,,,,,,,,
,,Units,,,,Revenue Gross,,,,,,,,Revenue Net of Tax,,,,,,Gross Avg/Ticket,,,,,,Net of Tax Avg/Ticket,,,,,,,,,,,,,,,,,,,,,,,,,,,,,,,,,,,,,,,,,,,,,,,,,,,,,,,,,,,,,,,,,,,,,,,,,,,,,,,,,,,,,,,,,,,,,,,,,,,,,,,,,,,,,,,,,,
,Day,2024,2025,,,2024,,,,,,,2025,2024,,,,,2025,2024,,,,,2025,2024,2025,,,,,,,,,,,,,,,,,,,,,,,,,,,,,,,,,,,,,,,,,,,,,,,,,,,,,,,,,,,,,,,,,,,,,,,,,,,,,,,,,,,,,,,,,,,,,,,,,,,,,,,,,,,,,,,,,
,,,,,,,,,,,,,,,,,,,,,,,,,,,,,,,,,,,,,,,,,,,,,,,,,,,,,,,,,,,,,,,,,,,,,,,,,,,,,,,,,,,,,,,,,,,,,,,,,,,,,,,,,,,,,,,,,,,,,,,,,,,,,,,,,,,,,,,,,,,,
,1," 4,368 "," 3,145 ",,," $90,865.10 ",,,,,,," $69,266.36 "," $71,322.68 ",,,,," $51,923.81 ", $20.80 ,,,,, $22.02 , $16.33 , $16.51 ,,,,,,,,,,,,,,,,,,,,,,,,,,,,,,,,,,,,,,,,,,,,,,,,,,,,,,,,,,,,,,,,,,,,,,,,,,,,,,,,,,,,,,,,,,,,,,,,,,,,,,,,,,,,,,,,,
,2," 3,127 "," 3,437 ",,," $61,987.43 ",,,,,,," $76,801.88 "," $48,655.75 ",,,,," $57,572.62 ", $19.82 ,,,,, $22.35 , $15.56 , $16.75 ,,,,,,,,,,,,,,,,,,,,,,,,,,,,,,,,,,,,,,,,,,,,,,,,,,,,,,,,,,,,,,,,,,,,,,,,,,,,,,,,,,,,,,,,,,,,,,,,,,,,,,,,,,,,,,,,,
,3," 3,652 "," 2,549 ",,," $75,441.58 ",,,,,,," $61,844.35 "," $59,216.31 ",,,,," $46,360.08 ", $20.66 ,,,,, $24.26 , $16.21 , $18.19 ,,,,,,,,,,,,,,,,,,,,,,,,,,,,,,,,,,,,,,,,,,,,,,,,,,,,,,,,,,,,,,,,,,,,,,,,,,,,,,,,,,,,,,,,,,,,,,,,,,,,,,,,,,,,,,,,,
,4," 3,390 "," 2,384 ",,," $82,353.78 ",,,,,,," $66,825.96 "," $64,641.90 ",,,,," $50,094.42 ", $24.29 ,,,,, $28.03 , $19.07 , $21.01 ,,,,,,,,,,,,,,,,,,,,,,,,,,,,,,,,,,,,,,,,,,,,,,,,,,,,,,,,,,,,,,,,,,,,,,,,,,,,,,,,,,,,,,,,,,,,,,,,,,,,,,,,,,,,,,,,,
,5," 3,540 "," 3,018 ",,," $82,152.97 ",,,,,,," $105,658.31 "," $64,484.28 ",,,,," $79,204.13 ", $23.21 ,,,,, $35.01 , $18.22 , $26.24 ,,,,,,,,,,,,,,,,,,,,,,,,,,,,,,,,,,,,,,,,,,,,,,,,,,,,,,,,,,,,,,,,,,,,,,,,,,,,,,,,,,,,,,,,,,,,,,,,,,,,,,,,,,,,,,,,,
,6," 2,239 "," 2,717 ",,," $102,402.03 ",,,,,,," $103,925.90 "," $80,378.36 ",,,,," $77,905.47 ", $45.74 ,,,,, $38.25 , $35.90 , $28.67 ,,,,,,,,,,,,,,,,,,,,,,,,,,,,,,,,,,,,,,,,,,,,,,,,,,,,,,,,,,,,,,,,,,,,,,,,,,,,,,,,,,,,,,,,,,,,,,,,,,,,,,,,,,,,,,,,,
,7," 2,001 "," 3,319 ",,," $91,623.82 ",,,,,,," $74,742.39 "," $71,918.23 ",,,,," $56,028.78 ", $45.79 ,,,,, $22.52 , $35.94 , $16.88 ,,,,,,,,,,,,,,,,,,,,,,,,,,,,,,,,,,,,,,,,,,,,,,,,,,,,,,,,,,,,,,,,,,,,,,,,,,,,,,,,,,,,,,,,,,,,,,,,,,,,,,,,,,,,,,,,,
,8," 3,958 "," 3,139 ",,," $76,994.06 ",,,,,,," $65,019.03 "," $60,434.90 ",,,,," $48,739.90 ", $19.45 ,,,,, $20.71 , $15.27 , $15.53 ,,,,,,,,,,,,,,,,,,,,,,,,,,,,,,,,,,,,,,,,,,,,,,,,,,,,,,,,,,,,,,,,,,,,,,,,,,,,,,,,,,,,,,,,,,,,,,,,,,,,,,,,,,,,,,,,,
,9," 2,952 "," 3,992 ",,," $54,214.03 ",,,,,,," $86,128.28 "," $42,554.18 ",,,,," $64,563.93 ", $18.37 ,,,,, $21.58 , $14.42 , $16.17 ,,,,,,,,,,,,,,,,,,,,,,,,,,,,,,,,,,,,,,,,,,,,,,,,,,,,,,,,,,,,,,,,,,,,,,,,,,,,,,,,,,,,,,,,,,,,,,,,,,,,,,,,,,,,,,,,,
,10," 3,793 "," 3,840 ",,," $68,667.25 ",,,,,,," $82,917.00 "," $53,898.94 ",,,,," $62,156.67 ", $18.10 ,,,,, $21.59 , $14.21 , $16.19 ,,,,,,,,,,,,,,,,,,,,,,,,,,,,,,,,,,,,,,,,,,,,,,,,,,,,,,,,,,,,,,,,,,,,,,,,,,,,,,,,,,,,,,,,,,,,,,,,,,,,,,,,,,,,,,,,,
,11," 4,208 "," 3,615 ",,," $80,249.15 ",,,,,,," $85,612.87 "," $62,989.91 ",,,,," $64,177.56 ", $19.07 ,,,,, $23.68 , $14.97 , $17.75 ,,,,,,,,,,,,,,,,,,,,,,,,,,,,,,,,,,,,,,,,,,,,,,,,,,,,,,,,,,,,,,,,,,,,,,,,,,,,,,,,,,,,,,,,,,,,,,,,,,,,,,,,,,,,,,,,,
,12," 3,954 "," 5,047 ",,," $84,037.62 ",,,,,,," $137,796.81 "," $65,963.59 ",,,,," $103,295.96 ", $21.25 ,,,,, $27.30 , $16.68 , $20.47 ,,,,,,,,,,,,,,,,,,,,,,,,,,,,,,,,,,,,,,,,,,,,,,,,,,,,,,,,,,,,,,,,,,,,,,,,,,,,,,,,,,,,,,,,,,,,,,,,,,,,,,,,,,,,,,,,,
,13," 4,844 "," 4,096 ",,," $113,187.83 ",,,,,,," $115,376.62 "," $88,844.45 ",,,,," $86,489.22 ", $23.37 ,,,,, $28.17 , $18.34 , $21.12 ,,,,,,,,,,,,,,,,,,,,,,,,,,,,,,,,,,,,,,,,,,,,,,,,,,,,,,,,,,,,,,,,,,,,,,,,,,,,,,,,,,,,,,,,,,,,,,,,,,,,,,,,,,,,,,,,,
,14," 3,536 "," 3,569 ",,," $90,250.78 ",,,,,,," $81,222.11 "," $70,840.49 ",,,,," $60,886.14 ", $25.52 ,,,,, $22.76 , $20.03 , $17.06 ,,,,,,,,,,,,,,,,,,,,,,,,,,,,,,,,,,,,,,,,,,,,,,,,,,,,,,,,,,,,,,,,,,,,,,,,,,,,,,,,,,,,,,,,,,,,,,,,,,,,,,,,,,,,,,,,,
,15," 3,559 "," 3,499 ",,," $71,062.70 ",,,,,,," $73,239.52 "," $55,779.20 ",,,,," $54,902.19 ", $19.97 ,,,,, $20.93 , $15.67 , $15.69 ,,,,,,,,,,,,,,,,,,,,,,,,,,,,,,,,,,,,,,,,,,,,,,,,,,,,,,,,,,,,,,,,,,,,,,,,,,,,,,,,,,,,,,,,,,,,,,,,,,,,,,,,,,,,,,,,,
,16," 4,139 "," 3,803 ",,," $75,701.78 ",,,,,,," $79,893.95 "," $59,420.55 ",,,,," $59,890.52 ", $18.29 ,,,,, $21.01 , $14.36 , $15.75 ,,,,,,,,,,,,,,,,,,,,,,,,,,,,,,,,,,,,,,,,,,,,,,,,,,,,,,,,,,,,,,,,,,,,,,,,,,,,,,,,,,,,,,,,,,,,,,,,,,,,,,,,,,,,,,,,,
,17," 4,211 "," 4,585 ",,," $77,891.76 ",,,,,,," $100,973.85 "," $61,139.53 ",,,,," $75,692.54 ", $18.50 ,,,,, $22.02 , $14.52 , $16.51 ,,,,,,,,,,,,,,,,,,,,,,,,,,,,,,,,,,,,,,,,,,,,,,,,,,,,,,,,,,,,,,,,,,,,,,,,,,,,,,,,,,,,,,,,,,,,,,,,,,,,,,,,,,,,,,,,,
,18," 4,425 "," 5,021 ",,," $91,002.09 ",,,,,,," $126,593.80 "," $71,430.21 ",,,,," $94,897.90 ", $20.57 ,,,,, $25.21 , $16.14 , $18.90 ,,,,,,,,,,,,,,,,,,,,,,,,,,,,,,,,,,,,,,,,,,,,,,,,,,,,,,,,,,,,,,,,,,,,,,,,,,,,,,,,,,,,,,,,,,,,,,,,,,,,,,,,,,,,,,,,,
,19," 4,812 "," 5,984 ",,," $107,013.88 ",,,,,,," $163,143.95 "," $83,998.34 ",,,,," $122,296.81 ", $22.24 ,,,,, $27.26 , $17.46 , $20.44 ,,,,,,,,,,,,,,,,,,,,,,,,,,,,,,,,,,,,,,,,,,,,,,,,,,,,,,,,,,,,,,,,,,,,,,,,,,,,,,,,,,,,,,,,,,,,,,,,,,,,,,,,,,,,,,,,,
,20," 6,092 "," 4,033 ",,," $171,112.60 ",,,,,,," $119,729.96 "," $134,311.30 ",,,,," $89,752.59 ", $28.09 ,,,,, $29.69 , $22.05 , $22.25 ,,,,,,,,,,,,,,,,,,,,,,,,,,,,,,,,,,,,,,,,,,,,,,,,,,,,,,,,,,,,,,,,,,,,,,,,,,,,,,,,,,,,,,,,,,,,,,,,,,,,,,,,,,,,,,,,,
,21," 4,299 "," 3,843 ",,," $125,543.70 ",,,,,,," $92,260.52 "," $98,542.94 ",,,,," $69,160.81 ", $29.20 ,,,,, $24.01 , $22.92 , $18.00 ,,,,,,,,,,,,,,,,,,,,,,,,,,,,,,,,,,,,,,,,,,,,,,,,,,,,,,,,,,,,,,,,,,,,,,,,,,,,,,,,,,,,,,,,,,,,,,,,,,,,,,,,,,,,,,,,,
,22," 4,304 "," 4,162 ",,," $88,532.61 ",,,,,,," $89,523.53 "," $69,491.84 ",,,,," $67,109.09 ", $20.57 ,,,,, $21.51 , $16.15 , $16.12 ,,,,,,,,,,,,,,,,,,,,,,,,,,,,,,,,,,,,,,,,,,,,,,,,,,,,,,,,,,,,,,,,,,,,,,,,,,,,,,,,,,,,,,,,,,,,,,,,,,,,,,,,,,,,,,,,,
,23," 3,963 "," 4,255 ",,," $77,535.92 ",,,,,,," $89,534.82 "," $60,860.22 ",,,,," $67,117.56 ", $19.56 ,,,,, $21.04 , $15.36 , $15.77 ,,,,,,,,,,,,,,,,,,,,,,,,,,,,,,,,,,,,,,,,,,,,,,,,,,,,,,,,,,,,,,,,,,,,,,,,,,,,,,,,,,,,,,,,,,,,,,,,,,,,,,,,,,,,,,,,,
,24," 4,369 "," 3,882 ",,," $82,084.44 ",,,,,,," $85,414.80 "," $64,430.49 ",,,,," $64,029.09 ", $18.79 ,,,,, $22.00 , $14.75 , $16.49 ,,,,,,,,,,,,,,,,,,,,,,,,,,,,,,,,,,,,,,,,,,,,,,,,,,,,,,,,,,,,,,,,,,,,,,,,,,,,,,,,,,,,,,,,,,,,,,,,,,,,,,,,,,,,,,,,,
,25," 4,215 "," 3,907 ",,," $83,702.57 ",,,,,,," $94,022.12 "," $65,700.60 ",,,,," $70,481.35 ", $19.86 ,,,,, $24.07 , $15.59 , $18.04 ,,,,,,,,,,,,,,,,,,,,,,,,,,,,,,,,,,,,,,,,,,,,,,,,,,,,,,,,,,,,,,,,,,,,,,,,,,,,,,,,,,,,,,,,,,,,,,,,,,,,,,,,,,,,,,,,,
,26," 4,028 "," 4,609 ",,," $86,722.61 ",,,,,,," $128,621.65 "," $68,071.12 ",,,,," $96,418.03 ", $21.53 ,,,,, $27.91 , $16.90 , $20.92 ,,,,,,,,,,,,,,,,,,,,,,,,,,,,,,,,,,,,,,,,,,,,,,,,,,,,,,,,,,,,,,,,,,,,,,,,,,,,,,,,,,,,,,,,,,,,,,,,,,,,,,,,,,,,,,,,,
,27," 5,783 "," 3,967 ",,," $144,821.66 ",,,,,,," $115,986.69 "," $113,674.77 ",,,,," $86,946.54 ", $25.04 ,,,,, $29.24 , $19.66 , $21.92 ,,,,,,,,,,,,,,,,,,,,,,,,,,,,,,,,,,,,,,,,,,,,,,,,,,,,,,,,,,,,,,,,,,,,,,,,,,,,,,,,,,,,,,,,,,,,,,,,,,,,,,,,,,,,,,,,,
,28," 3,601 "," 3,548 ",,," $95,743.49 ",,,,,,," $80,937.08 "," $75,151.88 ",,,,," $60,672.47 ", $26.59 ,,,,, $22.81 , $20.87 , $17.10 ,,,,,,,,,,,,,,,,,,,,,,,,,,,,,,,,,,,,,,,,,,,,,,,,,,,,,,,,,,,,,,,,,,,,,,,,,,,,,,,,,,,,,,,,,,,,,,,,,,,,,,,,,,,,,,,,,
,29," 3,651 "," 3,547 ",,," $77,016.11 ",,,,,,," $74,168.33 "," $60,452.21 ",,,,," $55,598.45 ", $21.09 ,,,,, $20.91 , $16.56 , $15.67 ,,,,,,,,,,,,,,,,,,,,,,,,,,,,,,,,,,,,,,,,,,,,,,,,,,,,,,,,,,,,,,,,,,,,,,,,,,,,,,,,,,,,,,,,,,,,,,,,,,,,,,,,,,,,,,,,,
,30," 4,040 ", -   ,,," $77,781.51 ",,,,,,, $-   ," $61,052.99 ",,,,, $-   , $19.25 ,,,,,#DIV/0!, $15.11 ,#DIV/0!,,,,,,,,,,,,,,,,,,,,,,,,,,,,,,,,,,,,,,,,,,,,,,,,,,,,,,,,,,,,,,,,,,,,,,,,,,,,,,,,,,,,,,,,,,,,,,,,,,,,,,,,,,,,,,,,,
,31," 5,480 ", -   ,,," $109,812.69 ",,,,,,, $-   ," $86,195.20 ",,,,,, $20.04 ,,,,,#DIV/0!, $15.73 ,#DIV/0!,,,,,,,,,,,,,,,,,,,,,,,,,,,,,,,,,,,,,,,,,,,,,,,,,,,,,,,,,,,,,,,,,,,,,,,,,,,,,,,,,,,,,,,,,,,,,,,,,,,,,,,,,,,,,,,,,
,,,,,,,,,,,,,,,,,,,,,,,,,,,,,,,,,,,,,,,,,,,,,,,,,,,,,,,,,,,,,,,,,,,,,,,,,,,,,,,,,,,,,,,,,,,,,,,,,,,,,,,,,,,,,,,,,,,,,,,,,,,,,,,,,,,,,,,,,,,,
,," 124,533 "," 110,512 ",,," $2,797,509.55 ",,,,,,," $2,727,182.44 "," $2,195,847.37 ",,,,," $2,044,364.65 ", $22.46 ,,,,, $24.68 , $17.63 , $18.50 ,,,,,,,,,,,,,,,,,,,,,,,,,,,,,,,,,,,,,,,,,,,,,,,,,,,,,,,,,,,,,,,,,,,,,,,,,,,,,,,,,,,,,,,,,,,,,,,,,,,,,,,,,,,,,,,,,
,,,,,,,,,,,,,,,,,,,,,,,,,,,,,,,,,,,,,,,,,,,,,,,,,,,,,,,,,,,,,,,,,,,,,,,,,,,,,,,,,,,,,,,,,,,,,,,,,,,,,,,,,,,,,,,,,,,,,,,,,,,,,,,,,,,,,,,,,,,,
,,,,,,,,,,,,,,,,,,,,,,,,,,,,,,,,,,,,,,,,,,,,,,,,,,,,,,,,,,,,,,,,,,,,,,,,,,,,,,,,,,,,,,,,,,,,,,,,,,,,,,,,,,,,,,,,,,,,,,,,,,,,,,,,,,,,,,,,,,,,
,,,,,,,,,,,,,,,,,,,,,,,,,,,,,,,,,,,,,,,,,,,,,,,,,,,,,,,,,,,,,,,,,,,,,,,,,,,,,,,,,,,,,,,,,,,,,,,,,,,,,,,,,,,,,,,,,,,,,,,,,,,,,,,,,,,,,,,,,,,,
,,,,,,,,,,,,,,,,,,,,,,,,,,,,,,,,,,,,,,,,,,,,,,,,,,,,,,,,,,,,,,,,,,,,,,,,,,,,,,,,,,,,,,,,,,,,,,,,,,,,,,,,,,,,,,,,,,,,,,,,,,,,,,,,,,,,,,,,,,,,
,,,,,,,,,,,,,,,,,,,,,,,,,,,,,,,,,,,,,,,,,,,,,,,,,,,,,,,,,,,,,,,,,,,,,,,,,,,,,,,,,,,,,,,,,,,,,,,,,,,,,,,,,,,,,,,,,,,,,,,,,,,,,,,,,,,,,,,,,,,,
,,,,,,,,,,,,,,,,,,,,,,,,,,,,,,,,,,,,,,,,,,,,,,,,,,,,,,,,,,,,,,,,,,,,,,,,,,,,,,,,,,,,,,,,,,,,,,,,,,,,,,,,,,,,,,,,,,,,,,,,,,,,,,,,,,,,,,,,,,,,
,,,,,,,,,,,,,,,,,,,,,,,,,,,,,,,,,,,,,,,,,,,,,,,,,,,,,,,,,,,,,,,,,,,,,,,,,,,,,,,,,,,,,,,,,,,,,,,,,,,,,,,,,,,,,,,,,,,,,,,,,,,,,,,,,,,,,,,,,,,,
,,,,,,,,,,,,,,,,,,,,,,,,,,,,,,,,,,,,,,,,,,,,,,,,,,,,,,,,,,,,,,,,,,,,,,,,,,,,,,,,,,,,,,,,,,,,,,,,,,,,,,,,,,,,,,,,,,,,,,,,,,,,,,,,,,,,,,,,,,,,
,,,,,,,,,,,,,,,,,,,,,,,,,,,,,,,,,,,,,,,,,,,,,,,,,,,,,,,,,,,,,,,,,,,,,,,,,,,,,,,,,,,,,,,,,,,,,,,,,,,,,,,,,,,,,,,,,,,,,,,,,,,,,,,,,,,,,,,,,,,,
,,,,,,,,,,,,,,,,,,,,,,,,,,,,,,,,,,,,,,,,,,,,,,,,,,,,,,,,,,,,,,,,,,,,,,,,,,,,,,,,,,,,,,,,,,,,,,,,,,,,,,,,,,,,,,,,,,,,,,,,,,,,,,,,,,,,,,,,,,,,
,,,,,,,,,,,,,,,,,,,,,,,,,,,,,,,,,,,,,,,,,,,,,,,,,,,,,,,,,,,,,,,,,,,,,,,,,,,,,,,,,,,,,,,,,,,,,,,,,,,,,,,,,,,,,,,,,,,,,,,,,,,,,,,,,,,,,,,,,,,,
,,,,,,,,,,,,,,,,,,,,,,,,,,,,,,,,,,,,,,,,,,,,,,,,,,,,,,,,,,,,,,,,,,,,,,,,,,,,,,,,,,,,,,,,,,,,,,,,,,,,,,,,,,,,,,,,,,,,,,,,,,,,,,,,,,,,,,,,,,,,
,,,,,,,,,,,,,,,,,,,,,,,,,,,,,,,,,,,,,,,,,,,,,,,,,,,,,,,,,,,,,,,,,,,,,,,,,,,,,,,,,,,,,,,,,,,,,,,,,,,,,,,,,,,,,,,,,,,,,,,,,,,,,,,,,,,,,,,,,,,,
,,,,,,,,,,,,,,,,,,,,,,,,,,,,,,,,,,,,,,,,,,,,,,,,,,,,,,,,,,,,,,,,,,,,,,,,,,,,,,,,,,,,,,,,,,,,,,,,,,,,,,,,,,,,,,,,,,,,,,,,,,,,,,,,,,,,,,,,,,,,
,,,,,,,,,,,,,,,,,,,,,,,,,,,,,,,,,,,,,,,,,,,,,,,,,,,,,,,,,,,,,,,,,,,,,,,,,,,,,,,,,,,,,,,,,,,,,,,,,,,,,,,,,,,,,,,,,,,,,,,,,,,,,,,,,,,,,,,,,,,,
,,,,,,,,,,,,,,,,,,,,,,,,,,,,,,,,,,,,,,,,,,,,,,,,,,,,,,,,,,,,,,,,,,,,,,,,,,,,,,,,,,,,,,,,,,,,,,,,,,,,,,,,,,,,,,,,,,,,,,,,,,,,,,,,,,,,,,,,,,,,
,,,,,,,,,,,,,,,,,,,,,,,,,,,,,,,,,,,,,,,,,,,,,,,,,,,,,,,,,,,,,,,,,,,,,,,,,,,,,,,,,,,,,,,,,,,,,,,,,,,,,,,,,,,,,,,,,,,,,,,,,,,,,,,,,,,,,,,,,,,,
,,,,,,,,,,,,,,,,,,,,,,,,,,,,,,,,,,,,,,,,,,,,,,,,,,,,,,,,,,,,,,,,,,,,,,,,,,,,,,,,,,,,,,,,,,,,,,,,,,,,,,,,,,,,,,,,,,,,,,,,,,,,,,,,,,,,,,,,,,,,
,,,,,,,,,,,,,,,,,,,,,,,,,,,,,,,,,,,,,,,,,,,,,,,,,,,,,,,,,,,,,,,,,,,,,,,,,,,,,,,,,,,,,,,,,,,,,,,,,,,,,,,,,,,,,,,,,,,,,,,,,,,,,,,,,,,,,,,,,,,,
,,,,,,,,,,,,,,,,,,,,,,,,,,,,,,,,,,,,,,,,,,,,,,,,,,,,,,,,,,,,,,,,,,,,,,,,,,,,,,,,,,,,,,,,,,,,,,,,,,,,,,,,,,,,,,,,,,,,,,,,,,,,,,,,,,,,,,,,,,,,
,,,,,,,,,,,,,,,,,,,,,,,,,,,,,,,,,,,,,,,,,,,,,,,,,,,,,,,,,,,,,,,,,,,,,,,,,,,,,,,,,,,,,,,,,,,,,,,,,,,,,,,,,,,,,,,,,,,,,,,,,,,,,,,,,,,,,,,,,,,,
,,,,,,,,,,,,,,,,,,,,,,,,,,,,,,,,,,,,,,,,,,,,,,,,,,,,,,,,,,,,,,,,,,,,,,,,,,,,,,,,,,,,,,,,,,,,,,,,,,,,,,,,,,,,,,,,,,,,,,,,,,,,,,,,,,,,,,,,,,,,
,,,,,,,,,,,,,,,,,,,,,,,,,,,,,,,,,,,,,,,,,,,,,,,,,,,,,,,,,,,,,,,,,,,,,,,,,,,,,,,,,,,,,,,,,,,,,,,,,,,,,,,,,,,,,,,,,,,,,,,,,,,,,,,,,,,,,,,,,,,,
,,,,,,,,,,,,,,,,,,,,,,,,,,,,,,,,,,,,,,,,,,,,,,,,,,,,,,,,,,,,,,,,,,,,,,,,,,,,,,,,,,,,,,,,,,,,,,,,,,,,,,,,,,,,,,,,,,,,,,,,,,,,,,,,,,,,,,,,,,,,
,,,,,,,,,,,,,,,,,,,,,,,,,,,,,,,,,,,,,,,,,,,,,,,,,,,,,,,,,,,,,,,,,,,,,,,,,,,,,,,,,,,,,,,,,,,,,,,,,,,,,,,,,,,,,,,,,,,,,,,,,,,,,,,,,,,,,,,,,,,,
,,,,,,,,,,,,,,,,,,,,,,,,,,,,,,,,,,,,,,,,,,,,,,,,,,,,,,,,,,,,,,,,,,,,,,,,,,,,,,,,,,,,,,,,,,,,,,,,,,,,,,,,,,,,,,,,,,,,,,,,,,,,,,,,,,,,,,,,,,,,
,,,,,,,,,,,,,,,,,,,,,,,,,,,,,,,,,,,,,,,,,,,,,,,,,,,,,,,,,,,,,,,,,,,,,,,,,,,,,,,,,,,,,,,,,,,,,,,,,,,,,,,,,,,,,,,,,,,,,,,,,,,,,,,,,,,,,,,,,,,,
,,,,,,,,,,,,,,,,,,,,,,,,,,,,,,,,,,,,,,,,,,,,,,,,,,,,,,,,,,,,,,,,,,,,,,,,,,,,,,,,,,,,,,,,,,,,,,,,,,,,,,,,,,,,,,,,,,,,,,,,,,,,,,,,,,,,,,,,,,,,
,,,,,,,,,,,,,,,,,,,,,,,,,,,,,,,,,,,,,,,,,,,,,,,,,,,,,,,,,,,,,,,,,,,,,,,,,,,,,,,,,,,,,,,,,,,,,,,,,,,,,,,,,,,,,,,,,,,,,,,,,,,,,,,,,,,,,,,,,,,,
,,,,,,,,,,,,,,,,,,,,,,,,,,,,,,,,,,,,,,,,,,,,,,,,,,,,,,,,,,,,,,,,,,,,,,,,,,,,,,,,,,,,,,,,,,,,,,,,,,,,,,,,,,,,,,,,,,,,,,,,,,,,,,,,,,,,,,,,,,,,
,,,,,,,,,,,,,,,,,,,,,,,,,,,,,,,,,,,,,,,,,,,,,,,,,,,,,,,,,,,,,,,,,,,,,,,,,,,,,,,,,,,,,,,,,,,,,,,,,,,,,,,,,,,,,,,,,,,,,,,,,,,,,,,,,,,,,,,,,,,,
,,,,,,,,,,,,,,,,,,,,,,,,,,,,,,,,,,,,,,,,,,,,,,,,,,,,,,,,,,,,,,,,,,,,,,,,,,,,,,,,,,,,,,,,,,,,,,,,,,,,,,,,,,,,,,,,,,,,,,,,,,,,,,,,,,,,,,,,,,,,
,,,,,,,,,,,,,,,,,,,,,,,,,,,,,,,,,,,,,,,,,,,,,,,,,,,,,,,,,,,,,,,,,,,,,,,,,,,,,,,,,,,,,,,,,,,,,,,,,,,,,,,,,,,,,,,,,,,,,,,,,,,,,,,,,,,,,,,,,,,,
,,,,,,,,,,,,,,,,,,,,,,,,,,,,,,,,,,,,,,,,,,,,,,,,,,,,,,,,,,,,,,,,,,,,,,,,,,,,,,,,,,,,,,,,,,,,,,,,,,,,,,,,,,,,,,,,,,,,,,,,,,,,,,,,,,,,,,,,,,,,
,,,,,,,,,,,,,,,,,,,,,,,,,,,,,,,,,,,,,,,,,,,,,,,,,,,,,,,,,,,,,,,,,,,,,,,,,,,,,,,,,,,,,,,,,,,,,,,,,,,,,,,,,,,,,,,,,,,,,,,,,,,,,,,,,,,,,,,,,,,,
,,,,,,,,,,,,,,,,,,,,,,,,,,,,,,,,,,,,,,,,,,,,,,,,,,,,,,,,,,,,,,,,,,,,,,,,,,,,,,,,,,,,,,,,,,,,,,,,,,,,,,,,,,,,,,,,,,,,,,,,,,,,,,,,,,,,,,,,,,,,
,,,,,,,,,,,,,,,,,,,,,,,,,,,,,,,,,,,,,,,,,,,,,,,,,,,,,,,,,,,,,,,,,,,,,,,,,,,,,,,,,,,,,,,,,,,,,,,,,,,,,,,,,,,,,,,,,,,,,,,,,,,,,,,,,,,,,,,,,,,,
,,,,,,,,,,,,,,,,,,,,,,,,,,,,,,,,,,,,,,,,,,,,,,,,,,,,,,,,,,,,,,,,,,,,,,,,,,,,,,,,,,,,,,,,,,,,,,,,,,,,,,,,,,,,,,,,,,,,,,,,,,,,,,,,,,,,,,,,,,,,
,,,,,,,,,,,,,,,,,,,,,,,,,,,,,,,,,,,,,,,,,,,,,,,,,,,,,,,,,,,,,,,,,,,,,,,,,,,,,,,,,,,,,,,,,,,,,,,,,,,,,,,,,,,,,,,,,,,,,,,,,,,,,,,,,,,,,,,,,,,,
,,,,,,,,,,,,,,,,,,,,,,,,,,,,,,,,,,,,,,,,,,,,,,,,,,,,,,,,,,,,,,,,,,,,,,,,,,,,,,,,,,,,,,,,,,,,,,,,,,,,,,,,,,,,,,,,,,,,,,,,,,,,,,,,,,,,,,,,,,,,
,,,,,,,,,,,,,,,,,,,,,,,,,,,,,,,,,,,,,,,,,,,,,,,,,,,,,,,,,,,,,,,,,,,,,,,,,,,,,,,,,,,,,,,,,,,,,,,,,,,,,,,,,,,,,,,,,,,,,,,,,,,,,,,,,,,,,,,,,,,,
,,,,,,,,,,,,,,,,,,,,,,,,,,,,,,,,,,,,,,,,,,,,,,,,,,,,,,,,,,,,,,,,,,,,,,,,,,,,,,,,,,,,,,,,,,,,,,,,,,,,,,,,,,,,,,,,,,,,,,,,,,,,,,,,,,,,,,,,,,,,
,,,,,,,,,,,,,,,,,,,,,,,,,,,,,,,,,,,,,,,,,,,,,,,,,,,,,,,,,,,,,,,,,,,,,,,,,,,,,,,,,,,,,,,,,,,,,,,,,,,,,,,,,,,,,,,,,,,,,,,,,,,,,,,,,,,,,,,,,,,,
,,,,,,,,,,,,,,,,,,,,,,,,,,,,,,,,,,,,,,,,,,,,,,,,,,,,,,,,,,,,,,,,,,,,,,,,,,,,,,,,,,,,,,,,,,,,,,,,,,,,,,,,,,,,,,,,,,,,,,,,,,,,,,,,,,,,,,,,,,,,
,,,,,,,,,,,,,,,,,,,,,,,,,,,,,,,,,,,,,,,,,,,,,,,,,,,,,,,,,,,,,,,,,,,,,,,,,,,,,,,,,,,,,,,,,,,,,,,,,,,,,,,,,,,,,,,,,,,,,,,,,,,,,,,,,,,,,,,,,,,,
,,,,,,,,,,,,,,,,,,,,,,,,,,,,,,,,,,,,,,,,,,,,,,,,,,,,,,,,,,,,,,,,,,,,,,,,,,,,,,,,,,,,,,,,,,,,,,,,,,,,,,,,,,,,,,,,,,,,,,,,,,,,,,,,,,,,,,,,,,,,
,,,,,,,,,,,,,,,,,,,,,,,,,,,,,,,,,,,,,,,,,,,,,,,,,,,,,,,,,,,,,,,,,,,,,,,,,,,,,,,,,,,,,,,,,,,,,,,,,,,,,,,,,,,,,,,,,,,,,,,,,,,,,,,,,,,,,,,,,,,,
,,,,,,,,,,,,,,,,,,,,,,,,,,,,,,,,,,,,,,,,,,,,,,,,,,,,,,,,,,,,,,,,,,,,,,,,,,,,,,,,,,,,,,,,,,,,,,,,,,,,,,,,,,,,,,,,,,,,,,,,,,,,,,,,,,,,,,,,,,,,
,,,,,,,,,,,,,,,,,,,,,,,,,,,,,,,,,,,,,,,,,,,,,,,,,,,,,,,,,,,,,,,,,,,,,,,,,,,,,,,,,,,,,,,,,,,,,,,,,,,,,,,,,,,,,,,,,,,,,,,,,,,,,,,,,,,,,,,,,,,,
,,,,,,,,,,,,,,,,,,,,,,,,,,,,,,,,,,,,,,,,,,,,,,,,,,,,,,,,,,,,,,,,,,,,,,,,,,,,,,,,,,,,,,,,,,,,,,,,,,,,,,,,,,,,,,,,,,,,,,,,,,,,,,,,,,,,,,,,,,,,
,,,,,,,,,,,,,,,,,,,,,,,,,,,,,,,,,,,,,,,,,,,,,,,,,,,,,,,,,,,,,,,,,,,,,,,,,,,,,,,,,,,,,,,,,,,,,,,,,,,,,,,,,,,,,,,,,,,,,,,,,,,,,,,,,,,,,,,,,,,,
,,,,,,,,,,,,,,,,,,,,,,,,,,,,,,,,,,,,,,,,,,,,,,,,,,,,,,,,,,,,,,,,,,,,,,,,,,,,,,,,,,,,,,,,,,,,,,,,,,,,,,,,,,,,,,,,,,,,,,,,,,,,,,,,,,,,,,,,,,,,
,,,,,,,,,,,,,,,,,,,,,,,,,,,,,,,,,,,,,,,,,,,,,,,,,,,,,,,,,,,,,,,,,,,,,,,,,,,,,,,,,,,,,,,,,,,,,,,,,,,,,,,,,,,,,,,,,,,,,,,,,,,,,,,,,,,,,,,,,,,,
,,,,,,,,,,,,,,,,,,,,,,,,,,,,,,,,,,,,,,,,,,,,,,,,,,,,,,,,,,,,,,,,,,,,,,,,,,,,,,,,,,,,,,,,,,,,,,,,,,,,,,,,,,,,,,,,,,,,,,,,,,,,,,,,,,,,,,,,,,,,
,,,,,,,,,,,,,,,,,,,,,,,,,,,,,,,,,,,,,,,,,,,,,,,,,,,,,,,,,,,,,,,,,,,,,,,,,,,,,,,,,,,,,,,,,,,,,,,,,,,,,,,,,,,,,,,,,,,,,,,,,,,,,,,,,,,,,,,,,,,,
,,,,,,,,,,,,,,,,,,,,,,,,,,,,,,,,,,,,,,,,,,,,,,,,,,,,,,,,,,,,,,,,,,,,,,,,,,,,,,,,,,,,,,,,,,,,,,,,,,,,,,,,,,,,,,,,,,,,,,,,,,,,,,,,,,,,,,,,,,,,
,,,,,,,,,,,,,,,,,,,,,,,,,,,,,,,,,,,,,,,,,,,,,,,,,,,,,,,,,,,,,,,,,,,,,,,,,,,,,,,,,,,,,,,,,,,,,,,,,,,,,,,,,,,,,,,,,,,,,,,,,,,,,,,,,,,,,,,,,,,,
,,,,,,,,,,,,,,,,,,,,,,,,,,,,,,,,,,,,,,,,,,,,,,,,,,,,,,,,,,,,,,,,,,,,,,,,,,,,,,,,,,,,,,,,,,,,,,,,,,,,,,,,,,,,,,,,,,,,,,,,,,,,,,,,,,,,,,,,,,,,
,,,,,,,,,,,,,,,,,,,,,,,,,,,,,,,,,,,,,,,,,,,,,,,,,,,,,,,,,,,,,,,,,,,,,,,,,,,,,,,,,,,,,,,,,,,,,,,,,,,,,,,,,,,,,,,,,,,,,,,,,,,,,,,,,,,,,,,,,,,,
,,,,,,,,,,,,,,,,,,,,,,,,,,,,,,,,,,,,,,,,,,,,,,,,,,,,,,,,,,,,,,,,,,,,,,,,,,,,,,,,,,,,,,,,,,,,,,,,,,,,,,,,,,,,,,,,,,,,,,,,,,,,,,,,,,,,,,,,,,,,
,,,,,,,,,,,,,,,,,,,,,,,,,,,,,,,,,,,,,,,,,,,,,,,,,,,,,,,,,,,,,,,,,,,,,,,,,,,,,,,,,,,,,,,,,,,,,,,,,,,,,,,,,,,,,,,,,,,,,,,,,,,,,,,,,,,,,,,,,,,,
,,,,,,,,,,,,,,,,,,,,,,,,,,,,,,,,,,,,,,,,,,,,,,,,,,,,,,,,,,,,,,,,,,,,,,,,,,,,,,,,,,,,,,,,,,,,,,,,,,,,,,,,,,,,,,,,,,,,,,,,,,,,,,,,,,,,,,,,,,,,
,,,,,,,,,,,,,,,,,,,,,,,,,,,,,,,,,,,,,,,,,,,,,,,,,,,,,,,,,,,,,,,,,,,,,,,,,,,,,,,,,,,,,,,,,,,,,,,,,,,,,,,,,,,,,,,,,,,,,,,,,,,,,,,,,,,,,,,,,,,,
,,,,,,,,,,,,,,,,,,,,,,,,,,,,,,,,,,,,,,,,,,,,,,,,,,,,,,,,,,,,,,,,,,,,,,,,,,,,,,,,,,,,,,,,,,,,,,,,,,,,,,,,,,,,,,,,,,,,,,,,,,,,,,,,,,,,,,,,,,,,
,,,,,,,,,,,,,,,,,,,,,,,,,,,,,,,,,,,,,,,,,,,,,,,,,,,,,,,,,,,,,,,,,,,,,,,,,,,,,,,,,,,,,,,,,,,,,,,,,,,,,,,,,,,,,,,,,,,,,,,,,,,,,,,,,,,,,,,,,,,,
,,,,,,,,,,,,,,,,,,,,,,,,,,,,,,,,,,,,,,,,,,,,,,,,,,,,,,,,,,,,,,,,,,,,,,,,,,,,,,,,,,,,,,,,,,,,,,,,,,,,,,,,,,,,,,,,,,,,,,,,,,,,,,,,,,,,,,,,,,,,
,,,,,,,,,,,,,,,,,,,,,,,,,,,,,,,,,,,,,,,,,,,,,,,,,,,,,,,,,,,,,,,,,,,,,,,,,,,,,,,,,,,,,,,,,,,,,,,,,,,,,,,,,,,,,,,,,,,,,,,,,,,,,,,,,,,,,,,,,,,,
,,,,,,,,,,,,,,,,,,,,,,,,,,,,,,,,,,,,,,,,,,,,,,,,,,,,,,,,,,,,,,,,,,,,,,,,,,,,,,,,,,,,,,,,,,,,,,,,,,,,,,,,,,,,,,,,,,,,,,,,,,,,,,,,,,,,,,,,,,,,
,,,,,,,,,,,,,,,,,,,,,,,,,,,,,,,,,,,,,,,,,,,,,,,,,,,,,,,,,,,,,,,,,,,,,,,,,,,,,,,,,,,,,,,,,,,,,,,,,,,,,,,,,,,,,,,,,,,,,,,,,,,,,,,,,,,,,,,,,,,,
,,,,,,,,,,,,,,,,,,,,,,,,,,,,,,,,,,,,,,,,,,,,,,,,,,,,,,,,,,,,,,,,,,,,,,,,,,,,,,,,,,,,,,,,,,,,,,,,,,,,,,,,,,,,,,,,,,,,,,,,,,,,,,,,,,,,,,,,,,,,
,,,,,,,,,,,,,,,,,,,,,,,,,,,,,,,,,,,,,,,,,,,,,,,,,,,,,,,,,,,,,,,,,,,,,,,,,,,,,,,,,,,,,,,,,,,,,,,,,,,,,,,,,,,,,,,,,,,,,,,,,,,,,,,,,,,,,,,,,,,,
,,,,,,,,,,,,,,,,,,,,,,,,,,,,,,,,,,,,,,,,,,,,,,,,,,,,,,,,,,,,,,,,,,,,,,,,,,,,,,,,,,,,,,,,,,,,,,,,,,,,,,,,,,,,,,,,,,,,,,,,,,,,,,,,,,,,,,,,,,,,
,,,,,,,,,,,,,,,,,,,,,,,,,,,,,,,,,,,,,,,,,,,,,,,,,,,,,,,,,,,,,,,,,,,,,,,,,,,,,,,,,,,,,,,,,,,,,,,,,,,,,,,,,,,,,,,,,,,,,,,,,,,,,,,,,,,,,,,,,,,,
,,,,,,,,,,,,,,,,,,,,,,,,,,,,,,,,,,,,,,,,,,,,,,,,,,,,,,,,,,,,,,,,,,,,,,,,,,,,,,,,,,,,,,,,,,,,,,,,,,,,,,,,,,,,,,,,,,,,,,,,,,,,,,,,,,,,,,,,,,,,
,,,,,,,,,,,,,,,,,,,,,,,,,,,,,,,,,,,,,,,,,,,,,,,,,,,,,,,,,,,,,,,,,,,,,,,,,,,,,,,,,,,,,,,,,,,,,,,,,,,,,,,,,,,,,,,,,,,,,,,,,,,,,,,,,,,,,,,,,,,,
,,,,,,,,,,,,,,,,,,,,,,,,,,,,,,,,,,,,,,,,,,,,,,,,,,,,,,,,,,,,,,,,,,,,,,,,,,,,,,,,,,,,,,,,,,,,,,,,,,,,,,,,,,,,,,,,,,,,,,,,,,,,,,,,,,,,,,,,,,,,
,,,,,,,,,,,,,,,,,,,,,,,,,,,,,,,,,,,,,,,,,,,,,,,,,,,,,,,,,,,,,,,,,,,,,,,,,,,,,,,,,,,,,,,,,,,,,,,,,,,,,,,,,,,,,,,,,,,,,,,,,,,,,,,,,,,,,,,,,,,,
,,,,,,,,,,,,,,,,,,,,,,,,,,,,,,,,,,,,,,,,,,,,,,,,,,,,,,,,,,,,,,,,,,,,,,,,,,,,,,,,,,,,,,,,,,,,,,,,,,,,,,,,,,,,,,,,,,,,,,,,,,,,,,,,,,,,,,,,,,,,
,,,,,,,,,,,,,,,,,,,,,,,,,,,,,,,,,,,,,,,,,,,,,,,,,,,,,,,,,,,,,,,,,,,,,,,,,,,,,,,,,,,,,,,,,,,,,,,,,,,,,,,,,,,,,,,,,,,,,,,,,,,,,,,,,,,,,,,,,,,,
,,,,,,,,,,,,,,,,,,,,,,,,,,,,,,,,,,,,,,,,,,,,,,,,,,,,,,,,,,,,,,,,,,,,,,,,,,,,,,,,,,,,,,,,,,,,,,,,,,,,,,,,,,,,,,,,,,,,,,,,,,,,,,,,,,,,,,,,,,,,
,,,,,,,,,,,,,,,,,,,,,,,,,,,,,,,,,,,,,,,,,,,,,,,,,,,,,,,,,,,,,,,,,,,,,,,,,,,,,,,,,,,,,,,,,,,,,,,,,,,,,,,,,,,,,,,,,,,,,,,,,,,,,,,,,,,,,,,,,,,,
,,,,,,,,,,,,,,,,,,,,,,,,,,,,,,,,,,,,,,,,,,,,,,,,,,,,,,,,,,,,,,,,,,,,,,,,,,,,,,,,,,,,,,,,,,,,,,,,,,,,,,,,,,,,,,,,,,,,,,,,,,,,,,,,,,,,,,,,,,,,
,,,,,,,,,,,,,,,,,,,,,,,,,,,,,,,,,,,,,,,,,,,,,,,,,,,,,,,,,,,,,,,,,,,,,,,,,,,,,,,,,,,,,,,,,,,,,,,,,,,,,,,,,,,,,,,,,,,,,,,,,,,,,,,,,,,,,,,,,,,,
,,,,,,,,,,,,,,,,,,,,,,,,,,,,,,,,,,,,,,,,,,,,,,,,,,,,,,,,,,,,,,,,,,,,,,,,,,,,,,,,,,,,,,,,,,,,,,,,,,,,,,,,,,,,,,,,,,,,,,,,,,,,,,,,,,,,,,,,,,,,
,,,,,,,,,,,,,,,,,,,,,,,,,,,,,,,,,,,,,,,,,,,,,,,,,,,,,,,,,,,,,,,,,,,,,,,,,,,,,,,,,,,,,,,,,,,,,,,,,,,,,,,,,,,,,,,,,,,,,,,,,,,,,,,,,,,,,,,,,,,,
,,,,,,,,,,,,,,,,,,,,,,,,,,,,,,,,,,,,,,,,,,,,,,,,,,,,,,,,,,,,,,,,,,,,,,,,,,,,,,,,,,,,,,,,,,,,,,,,,,,,,,,,,,,,,,,,,,,,,,,,,,,,,,,,,,,,,,,,,,,,
,,,,,,,,,,,,,,,,,,,,,,,,,,,,,,,,,,,,,,,,,,,,,,,,,,,,,,,,,,,,,,,,,,,,,,,,,,,,,,,,,,,,,,,,,,,,,,,,,,,,,,,,,,,,,,,,,,,,,,,,,,,,,,,,,,,,,,,,,,,,
,,,,,,,,,,,,,,,,,,,,,,,,,,,,,,,,,,,,,,,,,,,,,,,,,,,,,,,,,,,,,,,,,,,,,,,,,,,,,,,,,,,,,,,,,,,,,,,,,,,,,,,,,,,,,,,,,,,,,,,,,,,,,,,,,,,,,,,,,,,,
,,,,,,,,,,,,,,,,,,,,,,,,,,,,,,,,,,,,,,,,,,,,,,,,,,,,,,,,,,,,,,,,,,,,,,,,,,,,,,,,,,,,,,,,,,,,,,,,,,,,,,,,,,,,,,,,,,,,,,,,,,,,,,,,,,,,,,,,,,,,
,,,,,,,,,,,,,,,,,,,,,,,,,,,,,,,,,,,,,,,,,,,,,,,,,,,,,,,,,,,,,,,,,,,,,,,,,,,,,,,,,,,,,,,,,,,,,,,,,,,,,,,,,,,,,,,,,,,,,,,,,,,,,,,,,,,,,,,,,,,,
,,,,,,,,,,,,,,,,,,,,,,,,,,,,,,,,,,,,,,,,,,,,,,,,,,,,,,,,,,,,,,,,,,,,,,,,,,,,,,,,,,,,,,,,,,,,,,,,,,,,,,,,,,,,,,,,,,,,,,,,,,,,,,,,,,,,,,,,,,,,
,,,,,,,,,,,,,,,,,,,,,,,,,,,,,,,,,,,,,,,,,,,,,,,,,,,,,,,,,,,,,,,,,,,,,,,,,,,,,,,,,,,,,,,,,,,,,,,,,,,,,,,,,,,,,,,,,,,,,,,,,,,,,,,,,,,,,,,,,,,,
,,,,,,,,,,,,,,,,,,,,,,,,,,,,,,,,,,,,,,,,,,,,,,,,,,,,,,,,,,,,,,,,,,,,,,,,,,,,,,,,,,,,,,,,,,,,,,,,,,,,,,,,,,,,,,,,,,,,,,,,,,,,,,,,,,,,,,,,,,,,
,,,,,,,,,,,,,,,,,,,,,,,,,,,,,,,,,,,,,,,,,,,,,,,,,,,,,,,,,,,,,,,,,,,,,,,,,,,,,,,,,,,,,,,,,,,,,,,,,,,,,,,,,,,,,,,,,,,,,,,,,,,,,,,,,,,,,,,,,,,,
,,,,,,,,,,,,,,,,,,,,,,,,,,,,,,,,,,,,,,,,,,,,,,,,,,,,,,,,,,,,,,,,,,,,,,,,,,,,,,,,,,,,,,,,,,,,,,,,,,,,,,,,,,,,,,,,,,,,,,,,,,,,,,,,,,,,,,,,,,,,
,,,,,,,,,,,,,,,,,,,,,,,,,,,,,,,,,,,,,,,,,,,,,,,,,,,,,,,,,,,,,,,,,,,,,,,,,,,,,,,,,,,,,,,,,,,,,,,,,,,,,,,,,,,,,,,,,,,,,,,,,,,,,,,,,,,,,,,,,,,,
,,,,,,,,,,,,,,,,,,,,,,,,,,,,,,,,,,,,,,,,,,,,,,,,,,,,,,,,,,,,,,,,,,,,,,,,,,,,,,,,,,,,,,,,,,,,,,,,,,,,,,,,,,,,,,,,,,,,,,,,,,,,,,,,,,,,,,,,,,,,
,,,,,,,,,,,,,,,,,,,,,,,,,,,,,,,,,,,,,,,,,,,,,,,,,,,,,,,,,,,,,,,,,,,,,,,,,,,,,,,,,,,,,,,,,,,,,,,,,,,,,,,,,,,,,,,,,,,,,,,,,,,,,,,,,,,,,,,,,,,,
,,,,,,,,,,,,,,,,,,,,,,,,,,,,,,,,,,,,,,,,,,,,,,,,,,,,,,,,,,,,,,,,,,,,,,,,,,,,,,,,,,,,,,,,,,,,,,,,,,,,,,,,,,,,,,,,,,,,,,,,,,,,,,,,,,,,,,,,,,,,
,,,,,,,,,,,,,,,,,,,,,,,,,,,,,,,,,,,,,,,,,,,,,,,,,,,,,,,,,,,,,,,,,,,,,,,,,,,,,,,,,,,,,,,,,,,,,,,,,,,,,,,,,,,,,,,,,,,,,,,,,,,,,,,,,,,,,,,,,,,,
,,,,,,,,,,,,,,,,,,,,,,,,,,,,,,,,,,,,,,,,,,,,,,,,,,,,,,,,,,,,,,,,,,,,,,,,,,,,,,,,,,,,,,,,,,,,,,,,,,,,,,,,,,,,,,,,,,,,,,,,,,,,,,,,,,,,,,,,,,,,
,,,,,,,,,,,,,,,,,,,,,,,,,,,,,,,,,,,,,,,,,,,,,,,,,,,,,,,,,,,,,,,,,,,,,,,,,,,,,,,,,,,,,,,,,,,,,,,,,,,,,,,,,,,,,,,,,,,,,,,,,,,,,,,,,,,,,,,,,,,,
,,,,,,,,,,,,,,,,,,,,,,,,,,,,,,,,,,,,,,,,,,,,,,,,,,,,,,,,,,,,,,,,,,,,,,,,,,,,,,,,,,,,,,,,,,,,,,,,,,,,,,,,,,,,,,,,,,,,,,,,,,,,,,,,,,,,,,,,,,,,
,,,,,,,,,,,,,,,,,,,,,,,,,,,,,,,,,,,,,,,,,,,,,,,,,,,,,,,,,,,,,,,,,,,,,,,,,,,,,,,,,,,,,,,,,,,,,,,,,,,,,,,,,,,,,,,,,,,,,,,,,,,,,,,,,,,,,,,,,,,,
,,,,,,,,,,,,,,,,,,,,,,,,,,,,,,,,,,,,,,,,,,,,,,,,,,,,,,,,,,,,,,,,,,,,,,,,,,,,,,,,,,,,,,,,,,,,,,,,,,,,,,,,,,,,,,,,,,,,,,,,,,,,,,,,,,,,,,,,,,,,
,,,,,,,,,,,,,,,,,,,,,,,,,,,,,,,,,,,,,,,,,,,,,,,,,,,,,,,,,,,,,,,,,,,,,,,,,,,,,,,,,,,,,,,,,,,,,,,,,,,,,,,,,,,,,,,,,,,,,,,,,,,,,,,,,,,,,,,,,,,,
,,,,,,,,,,,,,,,,,,,,,,,,,,,,,,,,,,,,,,,,,,,,,,,,,,,,,,,,,,,,,,,,,,,,,,,,,,,,,,,,,,,,,,,,,,,,,,,,,,,,,,,,,,,,,,,,,,,,,,,,,,,,,,,,,,,,,,,,,,,,
,,,,,,,,,,,,,,,,,,,,,,,,,,,,,,,,,,,,,,,,,,,,,,,,,,,,,,,,,,,,,,,,,,,,,,,,,,,,,,,,,,,,,,,,,,,,,,,,,,,,,,,,,,,,,,,,,,,,,,,,,,,,,,,,,,,,,,,,,,,,
,,,,,,,,,,,,,,,,,,,,,,,,,,,,,,,,,,,,,,,,,,,,,,,,,,,,,,,,,,,,,,,,,,,,,,,,,,,,,,,,,,,,,,,,,,,,,,,,,,,,,,,,,,,,,,,,,,,,,,,,,,,,,,,,,,,,,,,,,,,,
,,,,,,,,,,,,,,,,,,,,,,,,,,,,,,,,,,,,,,,,,,,,,,,,,,,,,,,,,,,,,,,,,,,,,,,,,,,,,,,,,,,,,,,,,,,,,,,,,,,,,,,,,,,,,,,,,,,,,,,,,,,,,,,,,,,,,,,,,,,,
,,,,,,,,,,,,,,,,,,,,,,,,,,,,,,,,,,,,,,,,,,,,,,,,,,,,,,,,,,,,,,,,,,,,,,,,,,,,,,,,,,,,,,,,,,,,,,,,,,,,,,,,,,,,,,,,,,,,,,,,,,,,,,,,,,,,,,,,,,,,
,,,,,,,,,,,,,,,,,,,,,,,,,,,,,,,,,,,,,,,,,,,,,,,,,,,,,,,,,,,,,,,,,,,,,,,,,,,,,,,,,,,,,,,,,,,,,,,,,,,,,,,,,,,,,,,,,,,,,,,,,,,,,,,,,,,,,,,,,,,,
,,,,,,,,,,,,,,,,,,,,,,,,,,,,,,,,,,,,,,,,,,,,,,,,,,,,,,,,,,,,,,,,,,,,,,,,,,,,,,,,,,,,,,,,,,,,,,,,,,,,,,,,,,,,,,,,,,,,,,,,,,,,,,,,,,,,,,,,,,,,
,,,,,,,,,,,,,,,,,,,,,,,,,,,,,,,,,,,,,,,,,,,,,,,,,,,,,,,,,,,,,,,,,,,,,,,,,,,,,,,,,,,,,,,,,,,,,,,,,,,,,,,,,,,,,,,,,,,,,,,,,,,,,,,,,,,,,,,,,,,,
,,,,,,,,,,,,,,,,,,,,,,,,,,,,,,,,,,,,,,,,,,,,,,,,,,,,,,,,,,,,,,,,,,,,,,,,,,,,,,,,,,,,,,,,,,,,,,,,,,,,,,,,,,,,,,,,,,,,,,,,,,,,,,,,,,,,,,,,,,,,
,,,,,,,,,,,,,,,,,,,,,,,,,,,,,,,,,,,,,,,,,,,,,,,,,,,,,,,,,,,,,,,,,,,,,,,,,,,,,,,,,,,,,,,,,,,,,,,,,,,,,,,,,,,,,,,,,,,,,,,,,,,,,,,,,,,,,,,,,,,,
,,,,,,,,,,,,,,,,,,,,,,,,,,,,,,,,,,,,,,,,,,,,,,,,,,,,,,,,,,,,,,,,,,,,,,,,,,,,,,,,,,,,,,,,,,,,,,,,,,,,,,,,,,,,,,,,,,,,,,,,,,,,,,,,,,,,,,,,,,,,
,,,,,,,,,,,,,,,,,,,,,,,,,,,,,,,,,,,,,,,,,,,,,,,,,,,,,,,,,,,,,,,,,,,,,,,,,,,,,,,,,,,,,,,,,,,,,,,,,,,,,,,,,,,,,,,,,,,,,,,,,,,,,,,,,,,,,,,,,,,,
,,,,,,,,,,,,,,,,,,,,,,,,,,,,,,,,,,,,,,,,,,,,,,,,,,,,,,,,,,,,,,,,,,,,,,,,,,,,,,,,,,,,,,,,,,,,,,,,,,,,,,,,,,,,,,,,,,,,,,,,,,,,,,,,,,,,,,,,,,,,
,,,,,,,,,,,,,,,,,,,,,,,,,,,,,,,,,,,,,,,,,,,,,,,,,,,,,,,,,,,,,,,,,,,,,,,,,,,,,,,,,,,,,,,,,,,,,,,,,,,,,,,,,,,,,,,,,,,,,,,,,,,,,,,,,,,,,,,,,,,,
,,,,,,,,,,,,,,,,,,,,,,,,,,,,,,,,,,,,,,,,,,,,,,,,,,,,,,,,,,,,,,,,,,,,,,,,,,,,,,,,,,,,,,,,,,,,,,,,,,,,,,,,,,,,,,,,,,,,,,,,,,,,,,,,,,,,,,,,,,,,
,,,,,,,,,,,,,,,,,,,,,,,,,,,,,,,,,,,,,,,,,,,,,,,,,,,,,,,,,,,,,,,,,,,,,,,,,,,,,,,,,,,,,,,,,,,,,,,,,,,,,,,,,,,,,,,,,,,,,,,,,,,,,,,,,,,,,,,,,,,,
,,,,,,,,,,,,,,,,,,,,,,,,,,,,,,,,,,,,,,,,,,,,,,,,,,,,,,,,,,,,,,,,,,,,,,,,,,,,,,,,,,,,,,,,,,,,,,,,,,,,,,,,,,,,,,,,,,,,,,,,,,,,,,,,,,,,,,,,,,,,
,,,,,,,,,,,,,,,,,,,,,,,,,,,,,,,,,,,,,,,,,,,,,,,,,,,,,,,,,,,,,,,,,,,,,,,,,,,,,,,,,,,,,,,,,,,,,,,,,,,,,,,,,,,,,,,,,,,,,,,,,,,,,,,,,,,,,,,,,,,,
,,,,,,,,,,,,,,,,,,,,,,,,,,,,,,,,,,,,,,,,,,,,,,,,,,,,,,,,,,,,,,,,,,,,,,,,,,,,,,,,,,,,,,,,,,,,,,,,,,,,,,,,,,,,,,,,,,,,,,,,,,,,,,,,,,,,,,,,,,,,
,,,,,,,,,,,,,,,,,,,,,,,,,,,,,,,,,,,,,,,,,,,,,,,,,,,,,,,,,,,,,,,,,,,,,,,,,,,,,,,,,,,,,,,,,,,,,,,,,,,,,,,,,,,,,,,,,,,,,,,,,,,,,,,,,,,,,,,,,,,,
,,,,,,,,,,,,,,,,,,,,,,,,,,,,,,,,,,,,,,,,,,,,,,,,,,,,,,,,,,,,,,,,,,,,,,,,,,,,,,,,,,,,,,,,,,,,,,,,,,,,,,,,,,,,,,,,,,,,,,,,,,,,,,,,,,,,,,,,,,,,
,,,,,,,,,,,,,,,,,,,,,,,,,,,,,,,,,,,,,,,,,,,,,,,,,,,,,,,,,,,,,,,,,,,,,,,,,,,,,,,,,,,,,,,,,,,,,,,,,,,,,,,,,,,,,,,,,,,,,,,,,,,,,,,,,,,,,,,,,,,,
,,,,,,,,,,,,,,,,,,,,,,,,,,,,,,,,,,,,,,,,,,,,,,,,,,,,,,,,,,,,,,,,,,,,,,,,,,,,,,,,,,,,,,,,,,,,,,,,,,,,,,,,,,,,,,,,,,,,,,,,,,,,,,,,,,,,,,,,,,,,
,,,,,,,,,,,,,,,,,,,,,,,,,,,,,,,,,,,,,,,,,,,,,,,,,,,,,,,,,,,,,,,,,,,,,,,,,,,,,,,,,,,,,,,,,,,,,,,,,,,,,,,,,,,,,,,,,,,,,,,,,,,,,,,,,,,,,,,,,,,,
,,,,,,,,,,,,,,,,,,,,,,,,,,,,,,,,,,,,,,,,,,,,,,,,,,,,,,,,,,,,,,,,,,,,,,,,,,,,,,,,,,,,,,,,,,,,,,,,,,,,,,,,,,,,,,,,,,,,,,,,,,,,,,,,,,,,,,,,,,,,
,,,,,,,,,,,,,,,,,,,,,,,,,,,,,,,,,,,,,,,,,,,,,,,,,,,,,,,,,,,,,,,,,,,,,,,,,,,,,,,,,,,,,,,,,,,,,,,,,,,,,,,,,,,,,,,,,,,,,,,,,,,,,,,,,,,,,,,,,,,,
,,,,,,,,,,,,,,,,,,,,,,,,,,,,,,,,,,,,,,,,,,,,,,,,,,,,,,,,,,,,,,,,,,,,,,,,,,,,,,,,,,,,,,,,,,,,,,,,,,,,,,,,,,,,,,,,,,,,,,,,,,,,,,,,,,,,,,,,,,,,
,,,,,,,,,,,,,,,,,,,,,,,,,,,,,,,,,,,,,,,,,,,,,,,,,,,,,,,,,,,,,,,,,,,,,,,,,,,,,,,,,,,,,,,,,,,,,,,,,,,,,,,,,,,,,,,,,,,,,,,,,,,,,,,,,,,,,,,,,,,,
,,,,,,,,,,,,,,,,,,,,,,,,,,,,,,,,,,,,,,,,,,,,,,,,,,,,,,,,,,,,,,,,,,,,,,,,,,,,,,,,,,,,,,,,,,,,,,,,,,,,,,,,,,,,,,,,,,,,,,,,,,,,,,,,,,,,,,,,,,,,
,,,,,,,,,,,,,,,,,,,,,,,,,,,,,,,,,,,,,,,,,,,,,,,,,,,,,,,,,,,,,,,,,,,,,,,,,,,,,,,,,,,,,,,,,,,,,,,,,,,,,,,,,,,,,,,,,,,,,,,,,,,,,,,,,,,,,,,,,,,,
,,,,,,,,,,,,,,,,,,,,,,,,,,,,,,,,,,,,,,,,,,,,,,,,,,,,,,,,,,,,,,,,,,,,,,,,,,,,,,,,,,,,,,,,,,,,,,,,,,,,,,,,,,,,,,,,,,,,,,,,,,,,,,,,,,,,,,,,,,,,
,,,,,,,,,,,,,,,,,,,,,,,,,,,,,,,,,,,,,,,,,,,,,,,,,,,,,,,,,,,,,,,,,,,,,,,,,,,,,,,,,,,,,,,,,,,,,,,,,,,,,,,,,,,,,,,,,,,,,,,,,,,,,,,,,,,,,,,,,,,,
,,,,,,,,,,,,,,,,,,,,,,,,,,,,,,,,,,,,,,,,,,,,,,,,,,,,,,,,,,,,,,,,,,,,,,,,,,,,,,,,,,,,,,,,,,,,,,,,,,,,,,,,,,,,,,,,,,,,,,,,,,,,,,,,,,,,,,,,,,,,
,,,,,,,,,,,,,,,,,,,,,,,,,,,,,,,,,,,,,,,,,,,,,,,,,,,,,,,,,,,,,,,,,,,,,,,,,,,,,,,,,,,,,,,,,,,,,,,,,,,,,,,,,,,,,,,,,,,,,,,,,,,,,,,,,,,,,,,,,,,,
,,,,,,,,,,,,,,,,,,,,,,,,,,,,,,,,,,,,,,,,,,,,,,,,,,,,,,,,,,,,,,,,,,,,,,,,,,,,,,,,,,,,,,,,,,,,,,,,,,,,,,,,,,,,,,,,,,,,,,,,,,,,,,,,,,,,,,,,,,,,
,,,,,,,,,,,,,,,,,,,,,,,,,,,,,,,,,,,,,,,,,,,,,,,,,,,,,,,,,,,,,,,,,,,,,,,,,,,,,,,,,,,,,,,,,,,,,,,,,,,,,,,,,,,,,,,,,,,,,,,,,,,,,,,,,,,,,,,,,,,,
,,,,,,,,,,,,,,,,,,,,,,,,,,,,,,,,,,,,,,,,,,,,,,,,,,,,,,,,,,,,,,,,,,,,,,,,,,,,,,,,,,,,,,,,,,,,,,,,,,,,,,,,,,,,,,,,,,,,,,,,,,,,,,,,,,,,,,,,,,,,
,,,,,,,,,,,,,,,,,,,,,,,,,,,,,,,,,,,,,,,,,,,,,,,,,,,,,,,,,,,,,,,,,,,,,,,,,,,,,,,,,,,,,,,,,,,,,,,,,,,,,,,,,,,,,,,,,,,,,,,,,,,,,,,,,,,,,,,,,,,,
,,,,,,,,,,,,,,,,,,,,,,,,,,,,,,,,,,,,,,,,,,,,,,,,,,,,,,,,,,,,,,,,,,,,,,,,,,,,,,,,,,,,,,,,,,,,,,,,,,,,,,,,,,,,,,,,,,,,,,,,,,,,,,,,,,,,,,,,,,,,
,,,,,,,,,,,,,,,,,,,,,,,,,,,,,,,,,,,,,,,,,,,,,,,,,,,,,,,,,,,,,,,,,,,,,,,,,,,,,,,,,,,,,,,,,,,,,,,,,,,,,,,,,,,,,,,,,,,,,,,,,,,,,,,,,,,,,,,,,,,,
,,,,,,,,,,,,,,,,,,,,,,,,,,,,,,,,,,,,,,,,,,,,,,,,,,,,,,,,,,,,,,,,,,,,,,,,,,,,,,,,,,,,,,,,,,,,,,,,,,,,,,,,,,,,,,,,,,,,,,,,,,,,,,,,,,,,,,,,,,,,
,,,,,,,,,,,,,,,,,,,,,,,,,,,,,,,,,,,,,,,,,,,,,,,,,,,,,,,,,,,,,,,,,,,,,,,,,,,,,,,,,,,,,,,,,,,,,,,,,,,,,,,,,,,,,,,,,,,,,,,,,,,,,,,,,,,,,,,,,,,,
,,,,,,,,,,,,,,,,,,,,,,,,,,,,,,,,,,,,,,,,,,,,,,,,,,,,,,,,,,,,,,,,,,,,,,,,,,,,,,,,,,,,,,,,,,,,,,,,,,,,,,,,,,,,,,,,,,,,,,,,,,,,,,,,,,,,,,,,,,,,
,,,,,,,,,,,,,,,,,,,,,,,,,,,,,,,,,,,,,,,,,,,,,,,,,,,,,,,,,,,,,,,,,,,,,,,,,,,,,,,,,,,,,,,,,,,,,,,,,,,,,,,,,,,,,,,,,,,,,,,,,,,,,,,,,,,,,,,,,,,,
,,,,,,,,,,,,,,,,,,,,,,,,,,,,,,,,,,,,,,,,,,,,,,,,,,,,,,,,,,,,,,,,,,,,,,,,,,,,,,,,,,,,,,,,,,,,,,,,,,,,,,,,,,,,,,,,,,,,,,,,,,,,,,,,,,,,,,,,,,,,
,,,,,,,,,,,,,,,,,,,,,,,,,,,,,,,,,,,,,,,,,,,,,,,,,,,,,,,,,,,,,,,,,,,,,,,,,,,,,,,,,,,,,,,,,,,,,,,,,,,,,,,,,,,,,,,,,,,,,,,,,,,,,,,,,,,,,,,,,,,,
,,,,,,,,,,,,,,,,,,,,,,,,,,,,,,,,,,,,,,,,,,,,,,,,,,,,,,,,,,,,,,,,,,,,,,,,,,,,,,,,,,,,,,,,,,,,,,,,,,,,,,,,,,,,,,,,,,,,,,,,,,,,,,,,,,,,,,,,,,,,
,,,,,,,,,,,,,,,,,,,,,,,,,,,,,,,,,,,,,,,,,,,,,,,,,,,,,,,,,,,,,,,,,,,,,,,,,,,,,,,,,,,,,,,,,,,,,,,,,,,,,,,,,,,,,,,,,,,,,,,,,,,,,,,,,,,,,,,,,,,,
,,,,,,,,,,,,,,,,,,,,,,,,,,,,,,,,,,,,,,,,,,,,,,,,,,,,,,,,,,,,,,,,,,,,,,,,,,,,,,,,,,,,,,,,,,,,,,,,,,,,,,,,,,,,,,,,,,,,,,,,,,,,,,,,,,,,,,,,,,,,
,,,,,,,,,,,,,,,,,,,,,,,,,,,,,,,,,,,,,,,,,,,,,,,,,,,,,,,,,,,,,,,,,,,,,,,,,,,,,,,,,,,,,,,,,,,,,,,,,,,,,,,,,,,,,,,,,,,,,,,,,,,,,,,,,,,,,,,,,,,,
,,,,,,,,,,,,,,,,,,,,,,,,,,,,,,,,,,,,,,,,,,,,,,,,,,,,,,,,,,,,,,,,,,,,,,,,,,,,,,,,,,,,,,,,,,,,,,,,,,,,,,,,,,,,,,,,,,,,,,,,,,,,,,,,,,,,,,,,,,,,
,,,,,,,,,,,,,,,,,,,,,,,,,,,,,,,,,,,,,,,,,,,,,,,,,,,,,,,,,,,,,,,,,,,,,,,,,,,,,,,,,,,,,,,,,,,,,,,,,,,,,,,,,,,,,,,,,,,,,,,,,,,,,,,,,,,,,,,,,,,,
,,,,,,,,,,,,,,,,,,,,,,,,,,,,,,,,,,,,,,,,,,,,,,,,,,,,,,,,,,,,,,,,,,,,,,,,,,,,,,,,,,,,,,,,,,,,,,,,,,,,,,,,,,,,,,,,,,,,,,,,,,,,,,,,,,,,,,,,,,,,
,,,,,,,,,,,,,,,,,,,,,,,,,,,,,,,,,,,,,,,,,,,,,,,,,,,,,,,,,,,,,,,,,,,,,,,,,,,,,,,,,,,,,,,,,,,,,,,,,,,,,,,,,,,,,,,,,,,,,,,,,,,,,,,,,,,,,,,,,,,,
,,,,,,,,,,,,,,,,,,,,,,,,,,,,,,,,,,,,,,,,,,,,,,,,,,,,,,,,,,,,,,,,,,,,,,,,,,,,,,,,,,,,,,,,,,,,,,,,,,,,,,,,,,,,,,,,,,,,,,,,,,,,,,,,,,,,,,,,,,,,
,,,,,,,,,,,,,,,,,,,,,,,,,,,,,,,,,,,,,,,,,,,,,,,,,,,,,,,,,,,,,,,,,,,,,,,,,,,,,,,,,,,,,,,,,,,,,,,,,,,,,,,,,,,,,,,,,,,,,,,,,,,,,,,,,,,,,,,,,,,,
,,,,,,,,,,,,,,,,,,,,,,,,,,,,,,,,,,,,,,,,,,,,,,,,,,,,,,,,,,,,,,,,,,,,,,,,,,,,,,,,,,,,,,,,,,,,,,,,,,,,,,,,,,,,,,,,,,,,,,,,,,,,,,,,,,,,,,,,,,,,
,,,,,,,,,,,,,,,,,,,,,,,,,,,,,,,,,,,,,,,,,,,,,,,,,,,,,,,,,,,,,,,,,,,,,,,,,,,,,,,,,,,,,,,,,,,,,,,,,,,,,,,,,,,,,,,,,,,,,,,,,,,,,,,,,,,,,,,,,,,,
,,,,,,,,,,,,,,,,,,,,,,,,,,,,,,,,,,,,,,,,,,,,,,,,,,,,,,,,,,,,,,,,,,,,,,,,,,,,,,,,,,,,,,,,,,,,,,,,,,,,,,,,,,,,,,,,,,,,,,,,,,,,,,,,,,,,,,,,,,,,
,,,,,,,,,,,,,,,,,,,,,,,,,,,,,,,,,,,,,,,,,,,,,,,,,,,,,,,,,,,,,,,,,,,,,,,,,,,,,,,,,,,,,,,,,,,,,,,,,,,,,,,,,,,,,,,,,,,,,,,,,,,,,,,,,,,,,,,,,,,,
,,,,,,,,,,,,,,,,,,,,,,,,,,,,,,,,,,,,,,,,,,,,,,,,,,,,,,,,,,,,,,,,,,,,,,,,,,,,,,,,,,,,,,,,,,,,,,,,,,,,,,,,,,,,,,,,,,,,,,,,,,,,,,,,,,,,,,,,,,,,
,,,,,,,,,,,,,,,,,,,,,,,,,,,,,,,,,,,,,,,,,,,,,,,,,,,,,,,,,,,,,,,,,,,,,,,,,,,,,,,,,,,,,,,,,,,,,,,,,,,,,,,,,,,,,,,,,,,,,,,,,,,,,,,,,,,,,,,,,,,,
,,,,,,,,,,,,,,,,,,,,,,,,,,,,,,,,,,,,,,,,,,,,,,,,,,,,,,,,,,,,,,,,,,,,,,,,,,,,,,,,,,,,,,,,,,,,,,,,,,,,,,,,,,,,,,,,,,,,,,,,,,,,,,,,,,,,,,,,,,,,
,,,,,,,,,,,,,,,,,,,,,,,,,,,,,,,,,,,,,,,,,,,,,,,,,,,,,,,,,,,,,,,,,,,,,,,,,,,,,,,,,,,,,,,,,,,,,,,,,,,,,,,,,,,,,,,,,,,,,,,,,,,,,,,,,,,,,,,,,,,,
,,,,,,,,,,,,,,,,,,,,,,,,,,,,,,,,,,,,,,,,,,,,,,,,,,,,,,,,,,,,,,,,,,,,,,,,,,,,,,,,,,,,,,,,,,,,,,,,,,,,,,,,,,,,,,,,,,,,,,,,,,,,,,,,,,,,,,,,,,,,
,,,,,,,,,,,,,,,,,,,,,,,,,,,,,,,,,,,,,,,,,,,,,,,,,,,,,,,,,,,,,,,,,,,,,,,,,,,,,,,,,,,,,,,,,,,,,,,,,,,,,,,,,,,,,,,,,,,,,,,,,,,,,,,,,,,,,,,,,,,,
,,,,,,,,,,,,,,,,,,,,,,,,,,,,,,,,,,,,,,,,,,,,,,,,,,,,,,,,,,,,,,,,,,,,,,,,,,,,,,,,,,,,,,,,,,,,,,,,,,,,,,,,,,,,,,,,,,,,,,,,,,,,,,,,,,,,,,,,,,,,
,,,,,,,,,,,,,,,,,,,,,,,,,,,,,,,,,,,,,,,,,,,,,,,,,,,,,,,,,,,,,,,,,,,,,,,,,,,,,,,,,,,,,,,,,,,,,,,,,,,,,,,,,,,,,,,,,,,,,,,,,,,,,,,,,,,,,,,,,,,,
,,,,,,,,,,,,,,,,,,,,,,,,,,,,,,,,,,,,,,,,,,,,,,,,,,,,,,,,,,,,,,,,,,,,,,,,,,,,,,,,,,,,,,,,,,,,,,,,,,,,,,,,,,,,,,,,,,,,,,,,,,,,,,,,,,,,,,,,,,,,
,,,,,,,,,,,,,,,,,,,,,,,,,,,,,,,,,,,,,,,,,,,,,,,,,,,,,,,,,,,,,,,,,,,,,,,,,,,,,,,,,,,,,,,,,,,,,,,,,,,,,,,,,,,,,,,,,,,,,,,,,,,,,,,,,,,,,,,,,,,,
,,,,,,,,,,,,,,,,,,,,,,,,,,,,,,,,,,,,,,,,,,,,,,,,,,,,,,,,,,,,,,,,,,,,,,,,,,,,,,,,,,,,,,,,,,,,,,,,,,,,,,,,,,,,,,,,,,,,,,,,,,,,,,,,,,,,,,,,,,,,
,,,,,,,,,,,,,,,,,,,,,,,,,,,,,,,,,,,,,,,,,,,,,,,,,,,,,,,,,,,,,,,,,,,,,,,,,,,,,,,,,,,,,,,,,,,,,,,,,,,,,,,,,,,,,,,,,,,,,,,,,,,,,,,,,,,,,,,,,,,,
,,,,,,,,,,,,,,,,,,,,,,,,,,,,,,,,,,,,,,,,,,,,,,,,,,,,,,,,,,,,,,,,,,,,,,,,,,,,,,,,,,,,,,,,,,,,,,,,,,,,,,,,,,,,,,,,,,,,,,,,,,,,,,,,,,,,,,,,,,,,
,,,,,,,,,,,,,,,,,,,,,,,,,,,,,,,,,,,,,,,,,,,,,,,,,,,,,,,,,,,,,,,,,,,,,,,,,,,,,,,,,,,,,,,,,,,,,,,,,,,,,,,,,,,,,,,,,,,,,,,,,,,,,,,,,,,,,,,,,,,,
,,,,,,,,,,,,,,,,,,,,,,,,,,,,,,,,,,,,,,,,,,,,,,,,,,,,,,,,,,,,,,,,,,,,,,,,,,,,,,,,,,,,,,,,,,,,,,,,,,,,,,,,,,,,,,,,,,,,,,,,,,,,,,,,,,,,,,,,,,,,
,,,,,,,,,,,,,,,,,,,,,,,,,,,,,,,,,,,,,,,,,,,,,,,,,,,,,,,,,,,,,,,,,,,,,,,,,,,,,,,,,,,,,,,,,,,,,,,,,,,,,,,,,,,,,,,,,,,,,,,,,,,,,,,,,,,,,,,,,,,,
,,,,,,,,,,,,,,,,,,,,,,,,,,,,,,,,,,,,,,,,,,,,,,,,,,,,,,,,,,,,,,,,,,,,,,,,,,,,,,,,,,,,,,,,,,,,,,,,,,,,,,,,,,,,,,,,,,,,,,,,,,,,,,,,,,,,,,,,,,,,
,,,,,,,,,,,,,,,,,,,,,,,,,,,,,,,,,,,,,,,,,,,,,,,,,,,,,,,,,,,,,,,,,,,,,,,,,,,,,,,,,,,,,,,,,,,,,,,,,,,,,,,,,,,,,,,,,,,,,,,,,,,,,,,,,,,,,,,,,,,,
,,,,,,,,,,,,,,,,,,,,,,,,,,,,,,,,,,,,,,,,,,,,,,,,,,,,,,,,,,,,,,,,,,,,,,,,,,,,,,,,,,,,,,,,,,,,,,,,,,,,,,,,,,,,,,,,,,,,,,,,,,,,,,,,,,,,,,,,,,,,
,,,,,,,,,,,,,,,,,,,,,,,,,,,,,,,,,,,,,,,,,,,,,,,,,,,,,,,,,,,,,,,,,,,,,,,,,,,,,,,,,,,,,,,,,,,,,,,,,,,,,,,,,,,,,,,,,,,,,,,,,,,,,,,,,,,,,,,,,,,,
,,,,,,,,,,,,,,,,,,,,,,,,,,,,,,,,,,,,,,,,,,,,,,,,,,,,,,,,,,,,,,,,,,,,,,,,,,,,,,,,,,,,,,,,,,,,,,,,,,,,,,,,,,,,,,,,,,,,,,,,,,,,,,,,,,,,,,,,,,,,
,,,,,,,,,,,,,,,,,,,,,,,,,,,,,,,,,,,,,,,,,,,,,,,,,,,,,,,,,,,,,,,,,,,,,,,,,,,,,,,,,,,,,,,,,,,,,,,,,,,,,,,,,,,,,,,,,,,,,,,,,,,,,,,,,,,,,,,,,,,,
,,,,,,,,,,,,,,,,,,,,,,,,,,,,,,,,,,,,,,,,,,,,,,,,,,,,,,,,,,,,,,,,,,,,,,,,,,,,,,,,,,,,,,,,,,,,,,,,,,,,,,,,,,,,,,,,,,,,,,,,,,,,,,,,,,,,,,,,,,,,
,,,,,,,,,,,,,,,,,,,,,,,,,,,,,,,,,,,,,,,,,,,,,,,,,,,,,,,,,,,,,,,,,,,,,,,,,,,,,,,,,,,,,,,,,,,,,,,,,,,,,,,,,,,,,,,,,,,,,,,,,,,,,,,,,,,,,,,,,,,,
,,,,,,,,,,,,,,,,,,,,,,,,,,,,,,,,,,,,,,,,,,,,,,,,,,,,,,,,,,,,,,,,,,,,,,,,,,,,,,,,,,,,,,,,,,,,,,,,,,,,,,,,,,,,,,,,,,,,,,,,,,,,,,,,,,,,,,,,,,,,
,,,,,,,,,,,,,,,,,,,,,,,,,,,,,,,,,,,,,,,,,,,,,,,,,,,,,,,,,,,,,,,,,,,,,,,,,,,,,,,,,,,,,,,,,,,,,,,,,,,,,,,,,,,,,,,,,,,,,,,,,,,,,,,,,,,,,,,,,,,,
,,,,,,,,,,,,,,,,,,,,,,,,,,,,,,,,,,,,,,,,,,,,,,,,,,,,,,,,,,,,,,,,,,,,,,,,,,,,,,,,,,,,,,,,,,,,,,,,,,,,,,,,,,,,,,,,,,,,,,,,,,,,,,,,,,,,,,,,,,,,
,,,,,,,,,,,,,,,,,,,,,,,,,,,,,,,,,,,,,,,,,,,,,,,,,,,,,,,,,,,,,,,,,,,,,,,,,,,,,,,,,,,,,,,,,,,,,,,,,,,,,,,,,,,,,,,,,,,,,,,,,,,,,,,,,,,,,,,,,,,,
,,,,,,,,,,,,,,,,,,,,,,,,,,,,,,,,,,,,,,,,,,,,,,,,,,,,,,,,,,,,,,,,,,,,,,,,,,,,,,,,,,,,,,,,,,,,,,,,,,,,,,,,,,,,,,,,,,,,,,,,,,,,,,,,,,,,,,,,,,,,
,,,,,,,,,,,,,,,,,,,,,,,,,,,,,,,,,,,,,,,,,,,,,,,,,,,,,,,,,,,,,,,,,,,,,,,,,,,,,,,,,,,,,,,,,,,,,,,,,,,,,,,,,,,,,,,,,,,,,,,,,,,,,,,,,,,,,,,,,,,,
,,,,,,,,,,,,,,,,,,,,,,,,,,,,,,,,,,,,,,,,,,,,,,,,,,,,,,,,,,,,,,,,,,,,,,,,,,,,,,,,,,,,,,,,,,,,,,,,,,,,,,,,,,,,,,,,,,,,,,,,,,,,,,,,,,,,,,,,,,,,
,,,,,,,,,,,,,,,,,,,,,,,,,,,,,,,,,,,,,,,,,,,,,,,,,,,,,,,,,,,,,,,,,,,,,,,,,,,,,,,,,,,,,,,,,,,,,,,,,,,,,,,,,,,,,,,,,,,,,,,,,,,,,,,,,,,,,,,,,,,,
,,,,,,,,,,,,,,,,,,,,,,,,,,,,,,,,,,,,,,,,,,,,,,,,,,,,,,,,,,,,,,,,,,,,,,,,,,,,,,,,,,,,,,,,,,,,,,,,,,,,,,,,,,,,,,,,,,,,,,,,,,,,,,,,,,,,,,,,,,,,
,,,,,,,,,,,,,,,,,,,,,,,,,,,,,,,,,,,,,,,,,,,,,,,,,,,,,,,,,,,,,,,,,,,,,,,,,,,,,,,,,,,,,,,,,,,,,,,,,,,,,,,,,,,,,,,,,,,,,,,,,,,,,,,,,,,,,,,,,,,,
,,,,,,,,,,,,,,,,,,,,,,,,,,,,,,,,,,,,,,,,,,,,,,,,,,,,,,,,,,,,,,,,,,,,,,,,,,,,,,,,,,,,,,,,,,,,,,,,,,,,,,,,,,,,,,,,,,,,,,,,,,,,,,,,,,,,,,,,,,,,
,,,,,,,,,,,,,,,,,,,,,,,,,,,,,,,,,,,,,,,,,,,,,,,,,,,,,,,,,,,,,,,,,,,,,,,,,,,,,,,,,,,,,,,,,,,,,,,,,,,,,,,,,,,,,,,,,,,,,,,,,,,,,,,,,,,,,,,,,,,,
,,,,,,,,,,,,,,,,,,,,,,,,,,,,,,,,,,,,,,,,,,,,,,,,,,,,,,,,,,,,,,,,,,,,,,,,,,,,,,,,,,,,,,,,,,,,,,,,,,,,,,,,,,,,,,,,,,,,,,,,,,,,,,,,,,,,,,,,,,,,
,,,,,,,,,,,,,,,,,,,,,,,,,,,,,,,,,,,,,,,,,,,,,,,,,,,,,,,,,,,,,,,,,,,,,,,,,,,,,,,,,,,,,,,,,,,,,,,,,,,,,,,,,,,,,,,,,,,,,,,,,,,,,,,,,,,,,,,,,,,,
,,,,,,,,,,,,,,,,,,,,,,,,,,,,,,,,,,,,,,,,,,,,,,,,,,,,,,,,,,,,,,,,,,,,,,,,,,,,,,,,,,,,,,,,,,,,,,,,,,,,,,,,,,,,,,,,,,,,,,,,,,,,,,,,,,,,,,,,,,,,
,,,,,,,,,,,,,,,,,,,,,,,,,,,,,,,,,,,,,,,,,,,,,,,,,,,,,,,,,,,,,,,,,,,,,,,,,,,,,,,,,,,,,,,,,,,,,,,,,,,,,,,,,,,,,,,,,,,,,,,,,,,,,,,,,,,,,,,,,,,,
,,,,,,,,,,,,,,,,,,,,,,,,,,,,,,,,,,,,,,,,,,,,,,,,,,,,,,,,,,,,,,,,,,,,,,,,,,,,,,,,,,,,,,,,,,,,,,,,,,,,,,,,,,,,,,,,,,,,,,,,,,,,,,,,,,,,,,,,,,,,
,,,,,,,,,,,,,,,,,,,,,,,,,,,,,,,,,,,,,,,,,,,,,,,,,,,,,,,,,,,,,,,,,,,,,,,,,,,,,,,,,,,,,,,,,,,,,,,,,,,,,,,,,,,,,,,,,,,,,,,,,,,,,,,,,,,,,,,,,,,,
,,,,,,,,,,,,,,,,,,,,,,,,,,,,,,,,,,,,,,,,,,,,,,,,,,,,,,,,,,,,,,,,,,,,,,,,,,,,,,,,,,,,,,,,,,,,,,,,,,,,,,,,,,,,,,,,,,,,,,,,,,,,,,,,,,,,,,,,,,,,
,,,,,,,,,,,,,,,,,,,,,,,,,,,,,,,,,,,,,,,,,,,,,,,,,,,,,,,,,,,,,,,,,,,,,,,,,,,,,,,,,,,,,,,,,,,,,,,,,,,,,,,,,,,,,,,,,,,,,,,,,,,,,,,,,,,,,,,,,,,,
,,,,,,,,,,,,,,,,,,,,,,,,,,,,,,,,,,,,,,,,,,,,,,,,,,,,,,,,,,,,,,,,,,,,,,,,,,,,,,,,,,,,,,,,,,,,,,,,,,,,,,,,,,,,,,,,,,,,,,,,,,,,,,,,,,,,,,,,,,,,
,,,,,,,,,,,,,,,,,,,,,,,,,,,,,,,,,,,,,,,,,,,,,,,,,,,,,,,,,,,,,,,,,,,,,,,,,,,,,,,,,,,,,,,,,,,,,,,,,,,,,,,,,,,,,,,,,,,,,,,,,,,,,,,,,,,,,,,,,,,,
,,,,,,,,,,,,,,,,,,,,,,,,,,,,,,,,,,,,,,,,,,,,,,,,,,,,,,,,,,,,,,,,,,,,,,,,,,,,,,,,,,,,,,,,,,,,,,,,,,,,,,,,,,,,,,,,,,,,,,,,,,,,,,,,,,,,,,,,,,,,
,,,,,,,,,,,,,,,,,,,,,,,,,,,,,,,,,,,,,,,,,,,,,,,,,,,,,,,,,,,,,,,,,,,,,,,,,,,,,,,,,,,,,,,,,,,,,,,,,,,,,,,,,,,,,,,,,,,,,,,,,,,,,,,,,,,,,,,,,,,,
,,,,,,,,,,,,,,,,,,,,,,,,,,,,,,,,,,,,,,,,,,,,,,,,,,,,,,,,,,,,,,,,,,,,,,,,,,,,,,,,,,,,,,,,,,,,,,,,,,,,,,,,,,,,,,,,,,,,,,,,,,,,,,,,,,,,,,,,,,,,
,,,,,,,,,,,,,,,,,,,,,,,,,,,,,,,,,,,,,,,,,,,,,,,,,,,,,,,,,,,,,,,,,,,,,,,,,,,,,,,,,,,,,,,,,,,,,,,,,,,,,,,,,,,,,,,,,,,,,,,,,,,,,,,,,,,,,,,,,,,,
,,,,,,,,,,,,,,,,,,,,,,,,,,,,,,,,,,,,,,,,,,,,,,,,,,,,,,,,,,,,,,,,,,,,,,,,,,,,,,,,,,,,,,,,,,,,,,,,,,,,,,,,,,,,,,,,,,,,,,,,,,,,,,,,,,,,,,,,,,,,
,,,,,,,,,,,,,,,,,,,,,,,,,,,,,,,,,,,,,,,,,,,,,,,,,,,,,,,,,,,,,,,,,,,,,,,,,,,,,,,,,,,,,,,,,,,,,,,,,,,,,,,,,,,,,,,,,,,,,,,,,,,,,,,,,,,,,,,,,,,,
,,,,,,,,,,,,,,,,,,,,,,,,,,,,,,,,,,,,,,,,,,,,,,,,,,,,,,,,,,,,,,,,,,,,,,,,,,,,,,,,,,,,,,,,,,,,,,,,,,,,,,,,,,,,,,,,,,,,,,,,,,,,,,,,,,,,,,,,,,,,
,,,,,,,,,,,,,,,,,,,,,,,,,,,,,,,,,,,,,,,,,,,,,,,,,,,,,,,,,,,,,,,,,,,,,,,,,,,,,,,,,,,,,,,,,,,,,,,,,,,,,,,,,,,,,,,,,,,,,,,,,,,,,,,,,,,,,,,,,,,,
,,,,,,,,,,,,,,,,,,,,,,,,,,,,,,,,,,,,,,,,,,,,,,,,,,,,,,,,,,,,,,,,,,,,,,,,,,,,,,,,,,,,,,,,,,,,,,,,,,,,,,,,,,,,,,,,,,,,,,,,,,,,,,,,,,,,,,,,,,,,
,,,,,,,,,,,,,,,,,,,,,,,,,,,,,,,,,,,,,,,,,,,,,,,,,,,,,,,,,,,,,,,,,,,,,,,,,,,,,,,,,,,,,,,,,,,,,,,,,,,,,,,,,,,,,,,,,,,,,,,,,,,,,,,,,,,,,,,,,,,,
,,,,,,,,,,,,,,,,,,,,,,,,,,,,,,,,,,,,,,,,,,,,,,,,,,,,,,,,,,,,,,,,,,,,,,,,,,,,,,,,,,,,,,,,,,,,,,,,,,,,,,,,,,,,,,,,,,,,,,,,,,,,,,,,,,,,,,,,,,,,
,,,,,,,,,,,,,,,,,,,,,,,,,,,,,,,,,,,,,,,,,,,,,,,,,,,,,,,,,,,,,,,,,,,,,,,,,,,,,,,,,,,,,,,,,,,,,,,,,,,,,,,,,,,,,,,,,,,,,,,,,,,,,,,,,,,,,,,,,,,,
,,,,,,,,,,,,,,,,,,,,,,,,,,,,,,,,,,,,,,,,,,,,,,,,,,,,,,,,,,,,,,,,,,,,,,,,,,,,,,,,,,,,,,,,,,,,,,,,,,,,,,,,,,,,,,,,,,,,,,,,,,,,,,,,,,,,,,,,,,,,
,,,,,,,,,,,,,,,,,,,,,,,,,,,,,,,,,,,,,,,,,,,,,,,,,,,,,,,,,,,,,,,,,,,,,,,,,,,,,,,,,,,,,,,,,,,,,,,,,,,,,,,,,,,,,,,,,,,,,,,,,,,,,,,,,,,,,,,,,,,,
,,,,,,,,,,,,,,,,,,,,,,,,,,,,,,,,,,,,,,,,,,,,,,,,,,,,,,,,,,,,,,,,,,,,,,,,,,,,,,,,,,,,,,,,,,,,,,,,,,,,,,,,,,,,,,,,,,,,,,,,,,,,,,,,,,,,,,,,,,,,
,,,,,,,,,,,,,,,,,,,,,,,,,,,,,,,,,,,,,,,,,,,,,,,,,,,,,,,,,,,,,,,,,,,,,,,,,,,,,,,,,,,,,,,,,,,,,,,,,,,,,,,,,,,,,,,,,,,,,,,,,,,,,,,,,,,,,,,,,,,,
,,,,,,,,,,,,,,,,,,,,,,,,,,,,,,,,,,,,,,,,,,,,,,,,,,,,,,,,,,,,,,,,,,,,,,,,,,,,,,,,,,,,,,,,,,,,,,,,,,,,,,,,,,,,,,,,,,,,,,,,,,,,,,,,,,,,,,,,,,,,
,,,,,,,,,,,,,,,,,,,,,,,,,,,,,,,,,,,,,,,,,,,,,,,,,,,,,,,,,,,,,,,,,,,,,,,,,,,,,,,,,,,,,,,,,,,,,,,,,,,,,,,,,,,,,,,,,,,,,,,,,,,,,,,,,,,,,,,,,,,,
,,,,,,,,,,,,,,,,,,,,,,,,,,,,,,,,,,,,,,,,,,,,,,,,,,,,,,,,,,,,,,,,,,,,,,,,,,,,,,,,,,,,,,,,,,,,,,,,,,,,,,,,,,,,,,,,,,,,,,,,,,,,,,,,,,,,,,,,,,,,
,,,,,,,,,,,,,,,,,,,,,,,,,,,,,,,,,,,,,,,,,,,,,,,,,,,,,,,,,,,,,,,,,,,,,,,,,,,,,,,,,,,,,,,,,,,,,,,,,,,,,,,,,,,,,,,,,,,,,,,,,,,,,,,,,,,,,,,,,,,,
,,,,,,,,,,,,,,,,,,,,,,,,,,,,,,,,,,,,,,,,,,,,,,,,,,,,,,,,,,,,,,,,,,,,,,,,,,,,,,,,,,,,,,,,,,,,,,,,,,,,,,,,,,,,,,,,,,,,,,,,,,,,,,,,,,,,,,,,,,,,
,,,,,,,,,,,,,,,,,,,,,,,,,,,,,,,,,,,,,,,,,,,,,,,,,,,,,,,,,,,,,,,,,,,,,,,,,,,,,,,,,,,,,,,,,,,,,,,,,,,,,,,,,,,,,,,,,,,,,,,,,,,,,,,,,,,,,,,,,,,,
,,,,,,,,,,,,,,,,,,,,,,,,,,,,,,,,,,,,,,,,,,,,,,,,,,,,,,,,,,,,,,,,,,,,,,,,,,,,,,,,,,,,,,,,,,,,,,,,,,,,,,,,,,,,,,,,,,,,,,,,,,,,,,,,,,,,,,,,,,,,
,,,,,,,,,,,,,,,,,,,,,,,,,,,,,,,,,,,,,,,,,,,,,,,,,,,,,,,,,,,,,,,,,,,,,,,,,,,,,,,,,,,,,,,,,,,,,,,,,,,,,,,,,,,,,,,,,,,,,,,,,,,,,,,,,,,,,,,,,,,,
,,,,,,,,,,,,,,,,,,,,,,,,,,,,,,,,,,,,,,,,,,,,,,,,,,,,,,,,,,,,,,,,,,,,,,,,,,,,,,,,,,,,,,,,,,,,,,,,,,,,,,,,,,,,,,,,,,,,,,,,,,,,,,,,,,,,,,,,,,,,
,,,,,,,,,,,,,,,,,,,,,,,,,,,,,,,,,,,,,,,,,,,,,,,,,,,,,,,,,,,,,,,,,,,,,,,,,,,,,,,,,,,,,,,,,,,,,,,,,,,,,,,,,,,,,,,,,,,,,,,,,,,,,,,,,,,,,,,,,,,,
,,,,,,,,,,,,,,,,,,,,,,,,,,,,,,,,,,,,,,,,,,,,,,,,,,,,,,,,,,,,,,,,,,,,,,,,,,,,,,,,,,,,,,,,,,,,,,,,,,,,,,,,,,,,,,,,,,,,,,,,,,,,,,,,,,,,,,,,,,,,
,,,,,,,,,,,,,,,,,,,,,,,,,,,,,,,,,,,,,,,,,,,,,,,,,,,,,,,,,,,,,,,,,,,,,,,,,,,,,,,,,,,,,,,,,,,,,,,,,,,,,,,,,,,,,,,,,,,,,,,,,,,,,,,,,,,,,,,,,,,,
,,,,,,,,,,,,,,,,,,,,,,,,,,,,,,,,,,,,,,,,,,,,,,,,,,,,,,,,,,,,,,,,,,,,,,,,,,,,,,,,,,,,,,,,,,,,,,,,,,,,,,,,,,,,,,,,,,,,,,,,,,,,,,,,,,,,,,,,,,,,
,,,,,,,,,,,,,,,,,,,,,,,,,,,,,,,,,,,,,,,,,,,,,,,,,,,,,,,,,,,,,,,,,,,,,,,,,,,,,,,,,,,,,,,,,,,,,,,,,,,,,,,,,,,,,,,,,,,,,,,,,,,,,,,,,,,,,,,,,,,,
,,,,,,,,,,,,,,,,,,,,,,,,,,,,,,,,,,,,,,,,,,,,,,,,,,,,,,,,,,,,,,,,,,,,,,,,,,,,,,,,,,,,,,,,,,,,,,,,,,,,,,,,,,,,,,,,,,,,,,,,,,,,,,,,,,,,,,,,,,,,
,,,,,,,,,,,,,,,,,,,,,,,,,,,,,,,,,,,,,,,,,,,,,,,,,,,,,,,,,,,,,,,,,,,,,,,,,,,,,,,,,,,,,,,,,,,,,,,,,,,,,,,,,,,,,,,,,,,,,,,,,,,,,,,,,,,,,,,,,,,,
,,,,,,,,,,,,,,,,,,,,,,,,,,,,,,,,,,,,,,,,,,,,,,,,,,,,,,,,,,,,,,,,,,,,,,,,,,,,,,,,,,,,,,,,,,,,,,,,,,,,,,,,,,,,,,,,,,,,,,,,,,,,,,,,,,,,,,,,,,,,
,,,,,,,,,,,,,,,,,,,,,,,,,,,,,,,,,,,,,,,,,,,,,,,,,,,,,,,,,,,,,,,,,,,,,,,,,,,,,,,,,,,,,,,,,,,,,,,,,,,,,,,,,,,,,,,,,,,,,,,,,,,,,,,,,,,,,,,,,,,,
,,,,,,,,,,,,,,,,,,,,,,,,,,,,,,,,,,,,,,,,,,,,,,,,,,,,,,,,,,,,,,,,,,,,,,,,,,,,,,,,,,,,,,,,,,,,,,,,,,,,,,,,,,,,,,,,,,,,,,,,,,,,,,,,,,,,,,,,,,,,
,,,,,,,,,,,,,,,,,,,,,,,,,,,,,,,,,,,,,,,,,,,,,,,,,,,,,,,,,,,,,,,,,,,,,,,,,,,,,,,,,,,,,,,,,,,,,,,,,,,,,,,,,,,,,,,,,,,,,,,,,,,,,,,,,,,,,,,,,,,,
,,,,,,,,,,,,,,,,,,,,,,,,,,,,,,,,,,,,,,,,,,,,,,,,,,,,,,,,,,,,,,,,,,,,,,,,,,,,,,,,,,,,,,,,,,,,,,,,,,,,,,,,,,,,,,,,,,,,,,,,,,,,,,,,,,,,,,,,,,,,
,,,,,,,,,,,,,,,,,,,,,,,,,,,,,,,,,,,,,,,,,,,,,,,,,,,,,,,,,,,,,,,,,,,,,,,,,,,,,,,,,,,,,,,,,,,,,,,,,,,,,,,,,,,,,,,,,,,,,,,,,,,,,,,,,,,,,,,,,,,,
,,,,,,,,,,,,,,,,,,,,,,,,,,,,,,,,,,,,,,,,,,,,,,,,,,,,,,,,,,,,,,,,,,,,,,,,,,,,,,,,,,,,,,,,,,,,,,,,,,,,,,,,,,,,,,,,,,,,,,,,,,,,,,,,,,,,,,,,,,,,
,,,,,,,,,,,,,,,,,,,,,,,,,,,,,,,,,,,,,,,,,,,,,,,,,,,,,,,,,,,,,,,,,,,,,,,,,,,,,,,,,,,,,,,,,,,,,,,,,,,,,,,,,,,,,,,,,,,,,,,,,,,,,,,,,,,,,,,,,,,,
,,,,,,,,,,,,,,,,,,,,,,,,,,,,,,,,,,,,,,,,,,,,,,,,,,,,,,,,,,,,,,,,,,,,,,,,,,,,,,,,,,,,,,,,,,,,,,,,,,,,,,,,,,,,,,,,,,,,,,,,,,,,,,,,,,,,,,,,,,,,
,,,,,,,,,,,,,,,,,,,,,,,,,,,,,,,,,,,,,,,,,,,,,,,,,,,,,,,,,,,,,,,,,,,,,,,,,,,,,,,,,,,,,,,,,,,,,,,,,,,,,,,,,,,,,,,,,,,,,,,,,,,,,,,,,,,,,,,,,,,,
,,,,,,,,,,,,,,,,,,,,,,,,,,,,,,,,,,,,,,,,,,,,,,,,,,,,,,,,,,,,,,,,,,,,,,,,,,,,,,,,,,,,,,,,,,,,,,,,,,,,,,,,,,,,,,,,,,,,,,,,,,,,,,,,,,,,,,,,,,,,
,,,,,,,,,,,,,,,,,,,,,,,,,,,,,,,,,,,,,,,,,,,,,,,,,,,,,,,,,,,,,,,,,,,,,,,,,,,,,,,,,,,,,,,,,,,,,,,,,,,,,,,,,,,,,,,,,,,,,,,,,,,,,,,,,,,,,,,,,,,,
,,,,,,,,,,,,,,,,,,,,,,,,,,,,,,,,,,,,,,,,,,,,,,,,,,,,,,,,,,,,,,,,,,,,,,,,,,,,,,,,,,,,,,,,,,,,,,,,,,,,,,,,,,,,,,,,,,,,,,,,,,,,,,,,,,,,,,,,,,,,
,,,,,,,,,,,,,,,,,,,,,,,,,,,,,,,,,,,,,,,,,,,,,,,,,,,,,,,,,,,,,,,,,,,,,,,,,,,,,,,,,,,,,,,,,,,,,,,,,,,,,,,,,,,,,,,,,,,,,,,,,,,,,,,,,,,,,,,,,,,,
,,,,,,,,,,,,,,,,,,,,,,,,,,,,,,,,,,,,,,,,,,,,,,,,,,,,,,,,,,,,,,,,,,,,,,,,,,,,,,,,,,,,,,,,,,,,,,,,,,,,,,,,,,,,,,,,,,,,,,,,,,,,,,,,,,,,,,,,,,,,
,,,,,,,,,,,,,,,,,,,,,,,,,,,,,,,,,,,,,,,,,,,,,,,,,,,,,,,,,,,,,,,,,,,,,,,,,,,,,,,,,,,,,,,,,,,,,,,,,,,,,,,,,,,,,,,,,,,,,,,,,,,,,,,,,,,,,,,,,,,,
,,,,,,,,,,,,,,,,,,,,,,,,,,,,,,,,,,,,,,,,,,,,,,,,,,,,,,,,,,,,,,,,,,,,,,,,,,,,,,,,,,,,,,,,,,,,,,,,,,,,,,,,,,,,,,,,,,,,,,,,,,,,,,,,,,,,,,,,,,,,
,,,,,,,,,,,,,,,,,,,,,,,,,,,,,,,,,,,,,,,,,,,,,,,,,,,,,,,,,,,,,,,,,,,,,,,,,,,,,,,,,,,,,,,,,,,,,,,,,,,,,,,,,,,,,,,,,,,,,,,,,,,,,,,,,,,,,,,,,,,,
,,,,,,,,,,,,,,,,,,,,,,,,,,,,,,,,,,,,,,,,,,,,,,,,,,,,,,,,,,,,,,,,,,,,,,,,,,,,,,,,,,,,,,,,,,,,,,,,,,,,,,,,,,,,,,,,,,,,,,,,,,,,,,,,,,,,,,,,,,,,
,,,,,,,,,,,,,,,,,,,,,,,,,,,,,,,,,,,,,,,,,,,,,,,,,,,,,,,,,,,,,,,,,,,,,,,,,,,,,,,,,,,,,,,,,,,,,,,,,,,,,,,,,,,,,,,,,,,,,,,,,,,,,,,,,,,,,,,,,,,,
,,,,,,,,,,,,,,,,,,,,,,,,,,,,,,,,,,,,,,,,,,,,,,,,,,,,,,,,,,,,,,,,,,,,,,,,,,,,,,,,,,,,,,,,,,,,,,,,,,,,,,,,,,,,,,,,,,,,,,,,,,,,,,,,,,,,,,,,,,,,
,,,,,,,,,,,,,,,,,,,,,,,,,,,,,,,,,,,,,,,,,,,,,,,,,,,,,,,,,,,,,,,,,,,,,,,,,,,,,,,,,,,,,,,,,,,,,,,,,,,,,,,,,,,,,,,,,,,,,,,,,,,,,,"Hot Chocolate 15k/5k Race -GP. CSO event. High temp XX degrees fahrenheit. MPG entry only at LL 6:45-8:45, NB exit open. All other ramps closed. GPS entry closed, one exit open 6:45-8:45.GPN open.",,,,,,,,,,,,,,